announcements: announcements
funny: funny
AskReddit: Ask Reddit
gaming: gaming
aww: aww
Music: Music
pics: pics
science: science
worldnews: world news
todayilearned: today i learned
videos: videos
movies: movies
news: news
Showerthoughts: Shower thoughts
EarthPorn: Earth Porn
IAmA: I Am A
food: food
gifs: gifs
askscience: ask science
Jokes: Jokes
LifeProTips: Life Pro Tips
explainlikeimfive: explain like I'm five
books: books
Art: Art
nottheonion: not the onion
DIY: DIY
mildlyinteresting: mildly interesting
sports: sports
space: space
gadgets: gadgets
blog: blog
Documentaries: Documentaries
photoshopbattles: photoshop battles
GetMotivated: Get Motivated
tifu: tifu
UpliftingNews: Uplifting News
listentothis: listen to this
television: television
dataisbeautiful: data is beautiful
history: history
Internet Is Beautiful
philosophy
memes
Futurology
Writing Prompts
Old School Cool
nosleep
personal finance
creepy
Two X Chromosomes
technology
wallstreetbets
Advice Animals
wholesome memes
Fitness
interesting as fuck
politics
WTF
travel
oddly satisfying
Black People Twitter
best of
facepalm
life hacks
league of legends
Minecraft
relationship_advice
pcmasterrace
me_irl
What could go wrong
dank memes
Nature Is Fucking Lit
Tinder
PS4
Animals Being Bros
tattoos
dad jokes
trippin through time
photography
Bikini Bottom Twitter
next fucking level
nba
Animals Being Jerks
build a pc
Unexpected
Food Porn
woah dude
reaction gifs
Overwatch
gardening
instant regret
Pewdiepie Submissions
board games
Animals Being Derps
programming
Watch People Die Inside
pokemon
Damn that's interesting
Contagious Laughter
mildly infuriating
Parenting
gone wild
Public Freakout
pokemon go
Made Me Smile
relationships
iphone
Eat Cheap And Healthy
I took a picture
male fashion advice
Nintendo Switch
drawing
humor
woodworking
You Should Know
Games
xbox one
Outdoors
rare puppers
no no no yes
game of thrones
Gif Recipes
lose it
europe
cats
Bitcoin
Better Every Loop
Am I the Asshole
Awwducational
atheism
soccer
cursed comments
dating advice
High Quality Gifs
Children Falling Over
pc gaming
slow cooking
Makeup Addiction
Netflix Best Of
stocks
Cooking
Idiots In Cars
streetwear
Ask Men
History Porn
Crappy Design
Eye bleach
Well that sucks
confession
recipes
History Memes
teenagers
off my chest
nsfw
backpacking
Troll Y Chromosome
entertainment
apple
Real Girls
Murdered By Words
social skills
anime
trashy
keto
Coronavirus
how to
horror
DnD
sci fi
raspberry pi
cars
battlestations
biology
Android
Out Of The Loop
frugal male fashion
Humans Being Bros
Be Amazed
Movie Details
black magic fuckery
mac
Ask Women
No Stupid Questions
rick and morty
Deep Into YouTube
youtube haiku
Roast Me
learn programming
Kids Are Fucking Stupid
Crypto Currency
Road cam
White People Twitter
real life doodles
cool guides
wow
electronic music
dogs
nintendo
nfl
insane people facebook
bodyweight fitness
Choosing Beggars
Destiny The Game
NSFW_GIF
food hacks
Meal Prep Sunday
hardware
starter packs
unpopular opinion
instant karma
blursedimages: blursed images
therewasanattempt: there was an attempt
hiphopheads: hip hop heads
camping: camping
podcasts: podcasts
zelda: zelda
Sneakers: sneakers
HomeImprovement: Home Improvement
Design: Design
likeus: like us
Astronomy: Astronomy
whatisthisthing: what is this thing
ArtisanVideos: Artisan Videos
ArtefactPorn: Artefact Porn
youseeingthisshit: you seeing this shit
yesyesyesyesno: yes yes yes yes no
FiftyFifty: Fifty Fifty
ksi: ksi
indieheads: indie heads
sex: sex
natureismetal: nature is metal
StarWars: Star Wars
femalefashionadvice: female fashion advice
shittyfoodporn: shitty food porn
investing: investing
MachineLearning: Machine Learning
JusticeServed: Justice Served
nevertellmetheodds: never tell me the odds
PrequelMemes: Prequel Memes
hearthstone: hearthstone
CozyPlaces: Cozy Places
homestead: homestead
writing: writing
JUSTNOMIL: JUSTNO MIL
nasa: nasa
Frugal: Frugal
rareinsults: rare insults
hacking: hacking
Graffiti: Graffiti
ThriftStoreHauls: Thrift Store Hauls
comicbooks: comic books
urbanexploration: urban exploration
HolUp: Hol Up
madlads: mad lads
trees: trees
Filmmakers: Filmmakers
assholedesign: asshole design
hmmm: hmmm
Physics: Physics
PUBATTLEGROUNDS: PUBG
hentai: hentai
wallpaper: wallpaper
tipofmytongue: tip of my tongue
DunderMifflin: Dunder Mifflin
progresspics: progress pics
WeAreTheMusicMakers: We Are The Music Makers
spaceporn: space porn
JapanTravel: Japan Travel
savedyouaclick: saved you a click
LegalTeens: Legal Teens
GamePhysics: Game Physics
literature: literature
nutrition: nutrition
educationalgifs: educational gifs
solotravel: solo travel
cumsluts: cum sluts
quityourbullshit: quit your bullshit
marvelstudios: marvel studios
crafts: crafts
WinStupidPrizes: Win Stupid Prizes
SketchDaily: Sketch Daily
AnimalCrossing: Animal Crossing
math: math
Cinemagraphs: Cinemagraphs
comics: comics
PerfectTiming: Perfect Timing
holdmycosmo: hold my cosmo
Watches: Watches
iamverysmart: I am very smart
MMA: MMA
porn: porn
bodybuilding: bodybuilding
astrophotography: astrophotography
baseball: baseball
HealthyFood: Healthy Food
thewalkingdead: the walking dead
entitledparents: entitled parents
legaladvice: legal advice
meme: meme
FortNiteBR: Fortnite
comedyheaven: comedy heaven
audiophile: audiophile
CollegeBasketball: College Basketball
CasualConversation: Casual Conversation
conspiracy: conspiracy
BustyPetite: Busty Petite
rule34: rule 34
CampingandHiking: Camping and Hiking
pennystocks: penny stocks
MaliciousCompliance: Malicious Compliance
ProgrammerHumor: Programmer Humor
breakingbad: breakingbad
suggestmeabook: suggest me a book
technicallythetruth: technicallythetruth
cursedimages: cursed images
javascript: javascript
ATBGE: ATBGE
google: google
mealtimevideos: mealtimevideos
collegesluts: collegesluts
formula1: formula 1
AsiansGoneWild: Asians Gone Wild
SpecArt: Spec Art
ShittyLifeProTips: Shitty Life Pro Tips
PetiteGoneWild: Petite Gone Wild
MemeEconomy: Meme Economy
CatastrophicFailure: Catastrophic Failure
EDM: EDM
chemistry: chemistry
GirlsFinishingTheJob: Girls Finishing The Job
apexlegends: apex legends
StockMarket: Stock Market
Metal: Metal
techsupport: tech support
roadtrip: road trip
holdthemoan: hold the moan
compsci: comp sci
childfree: child free
hiking: hiking
Economics: Economics
KerbalSpaceProgram: Kerbal Space Program
MapPorn: Map Porn
running: running
adorableporn: adorable porn
PeopleFuckingDying: People Fucking Dying
rpg: RPG
cringepics: cringe pics
classicalmusic: classical music
dogecoin: dogecoin
UnresolvedMysteries: Unresolved Mysteries
PoliticalHumor: Political Humor
DoesAnybodyElse: Does Anybody Else
thatHappened: that Happened
Rainbow6: Rainbow 6
AskHistorians: Ask Historians
somethingimade: something I made
Health: Health
niceguys: nice guys
Fantasy: Fantasy
manga: manga
carporn: car porn
ShouldIbuythisgame: Should I buy this game
mashups: mashups
SkincareAddiction: Skincare Addiction
TIHI: TIHI
southpark: southpark
GlobalOffensive: Global Offensive
iamatotalpieceofshit: I Am A Total Piece Of Shit
2meirl4meirl: 2meirl4meirl
analog: analog
changemyview: change my view
AsianBeauty: Asian Beauty
AbandonedPorn: Abandoned Porn
PoliticalDiscussion: Political Discussion
Survival: Survival
TittyDrop: Titty Drop
cringe: cringe
softwaregore: software gore
DiWHY: DiWHY
ExposurePorn: Exposure Porn
RoomPorn: Room Porn
meirl: meirl
confusing_perspective: confusing perspective
hockey: hockey
Justrolledintotheshop: Just Rolled Into The Shop
insaneparents: insane parents
nsfw_gifs: nsfw gifs
FreeEBOOKS: Free EBOOKS
MachinePorn: Machine Porn
vandwellers: van dwellers
UnethicalLifeProTips: Unethical Life Pro Tips
photocritique: photo critique
Cringetopia: Cringetopia
specializedtools: specialized tools
holdmybeer: hold my beer
BiggerThanYouThought: Bigger Than You Thought
worldpolitics: world politics
TooAfraidToAsk: Too Afraid To Ask
4chan: 4chan
terriblefacebookmemes: terrible facebook memes
Shoestring: Shoestring
ADHD: ADHD
ethtrader: eth trader
ass: ass
LivestreamFail: Livestream Fail
privacy: privacy
self: self
Poetry: Poetry
PS5: PS5
maybemaybemaybe: maybe maybe maybe
toptalent: top talent
teslamotors: tesla motors
FuckYouKaren: Fuck You Karen
truegaming: true gaming
milf: MILF
IWantOut: I Want Out
fightporn: fight porn
digitalnomad: digital nomad
AbruptChaos: Abrupt Chaos
pussy: pussy
subredditoftheday: subreddit of the day
WhatsWrongWithYourDog: What's Wrong With Your Dog
snowboarding: snowboarding
greentext: greentext
DesignPorn: Design Porn
homeautomation: home automation
freefolk: freefolk
motorcycles: motorcycles
awfuleverything: awful everything
CFB: CFB
iamverybadass: I Am Very Badass
wheredidthesodago: where did the soda go
porninfifteenseconds: porn in fifteen seconds
skiing: skiing
skyrim: skyrim
ANormalDayInRussia: A Normal Day In Russia
ProRevenge: Pro Revenge
SweatyPalms: Sweaty Palms
Amateur: Amateur
BreedingMaterial: Breeding Material
WhyWereTheyFilming: Why Were They Filming
pawg: PAWG
powerwashingporn: power washing porn
ImGoingToHellForThis: I'm Going To Hell For This
Steam: Steam
wiiu: wiiu
Twitch: Twitch
perfectlycutscreams: perfectly cut screams
gifsthatkeepongiving: gifs that keep on giving
StartledCats: Startled Cats
nsfwhardcore: nsfw hardcore
Screenwriting: Screenwriting
Perfectfit: Perfect fit
pettyrevenge: petty revenge
Homebrewing: Homebrewing
algotrading: algo trading
Boxing: Boxing
oldpeoplefacebook: old people facebook
DeepFriedMemes: Deep Fried Memes
Zoomies: Zoomies
vagabond: vagabond
PornhubComments: Pornhub Comments
OnOff: On Off
Shitty_Car_Mods: Shitty Car Mods
Marvel: Marvel
MakeMeSuffer: Make Me Suffer
BoneAppleTea: Bone Apple Tea
westworld: westworld
oddlyterrifying: oddly terrifying
harrypotter: harry potter
anime_irl: anime irl
marvelmemes: marvel memes
LipsThatGrip: Lips That Grip
tumblr: tumblr
Bossfight: Boss fight
fakehistoryporn: fake history porn
3DS: 3DS
sadcringe: sad cringe
RocketLeague: Rocket League
Blowjobs: Blowjobs
Instagramreality: Instagram reality
woooosh: woooosh
Animemes: Animemes
modernwarfare: modern warfare
familyguy: family guy
LetsNotMeet: Let's Not Meet
JizzedToThis: Jizzed To This
bicycling: bicycling
OopsDidntMeanTo: Oops Didnt Mean To
gtaonline: gta online
TheLastAirbender: The Last Airbender
celebnsfw: celeb nsfw
ComedyCemetery: Comedy Cemetery
holdmyfeedingtube: hold my feeding tube
spacex: space x
Entrepreneur: Entrepreneur
canada: canada
HydroHomies: Hydro Homies
im14andthisisdeep: I'm 14 and this is deep
ThatsInsane: That's Insane
juicyasians: juicy asians
BuyItForLife: Buy It For Life
NSFWFunny: NSFW Funny
blessedimages: blessed images
FanTheories: Fan Theories
climbing: climbing
nostalgia: nostalgia
TrueOffMyChest: True Off My Chest
crappyoffbrands: crappy off brands
Amd: Amd
tiktoknsfw: tiktok nsfw
okbuddyretard: ok buddy retard
financialindependence: financial independence
reddit.com: reddit.com
Fishing: Fishing
UNBGBBIIVCHIDCTIICBG: UNBGBBIIVCHIDCTIICBG
fffffffuuuuuuuuuuuu: fffffffuuuuuuuuuuuu
forbiddensnacks: forbidden snacks
Genshin_Impact: Genshin Impact
IdiotsFightingThings: Idiots Fighting Things
cyberpunkgame: cyberpunk game
VALORANT: VALORANT
suspiciouslyspecific: suspiciously specific
holdmyredbull: hold my red bull
nononono: nononono
psychology: psychology
smashbros: smash bros
MechanicalKeyboards: Mechanical Keyboards
netflix: netflix
dankchristianmemes: dank christian memes
beta: beta
DotA2: DotA 2
Nude_Selfie: Nude Selfie
IDontWorkHereLady: I Dont Work Here Lady
AbsoluteUnits: Absolute Units
bigasses: big asses
gonewild30plus: gonewild 30 plus
ShitPostCrusaders: Shit Post Crusaders
anal: anal
shittyaskscience: shitty ask science
reddeadredemption: red dead redemption
IWantToLearn: I Want To Learn
Paranormal: Paranormal
lotrmemes: lotr memes
copypasta: copypasta
DidntKnowIWantedThat: Didnt Know I Wanted That
gatekeeping: gatekeeping
MostBeautiful: Most Beautiful
theydidthemath: they did the math
evilbuildings: evil buildings
thisismylifenow: this is my life now
aviation: aviation
Wallstreetbetsnew: Wallstreetbetsnew
GodPussy: God Pussy
TrollXChromosomes: Troll X Chromosomes
GameDeals: Game Deals
Guitar: Guitar
StardewValley: Stardew Valley
thalassophobia: thalassophobia
discordapp: discord app
nvidia: nvidia
TikTokCringe: TikTok Cringe
18_19: 18 19
confessions: confessions
buildapcsales: build a pc sales
ihadastroke: i had a stroke
AccidentalRenaissance: Accidental Renaissance
NoFap: No Fap
curvy: curvy
AsianHotties: Asian Hotties
webdev: web dev
surrealmemes: surreal memes
Fallout: Fallout
Python: Python
imsorryjon: im sorry jon
FellowKids: Fellow Kids
kpop: kpop
malelivingspace: male living space
BrandNewSentence: Brand New Sentence
CasualUK: Casual UK
getdisciplined: get disciplined
ethereum: ethereum
bonehurtingjuice: bone hurting juice
lesbians: lesbians
Glitch_in_the_Matrix: Glitch in the Matrix
justneckbeardthings: just neckbeard things
youngpeopleyoutube: young people youtube
goddesses: goddesses
Nudes: Nudes
freebies: freebies
yesyesyesno: yes yes yes no
Justfuckmyshitup: Just fuck my shit up
beermoney: beer money
blunderyears: blunder years
Drugs: Drugs
witcher: witcher
whitepeoplegifs: white people gifs
HappyEmbarrassedGirls: Happy Embarrassed Girls
dndmemes: dnd memes
options: options
HENTAI_GIF: HENTAI GIF
intermittentfasting: intermittent fasting
clevercomebacks: clever comebacks
GWCouples: GWCouples
WatchItForThePlot: Watch It For The Plot
dank_meme: dank meme
Conservative: Conservative
The_Donald: The Donald
depression: depression
SubredditDrama: Subreddit Drama
trashyboners: trashy boners
Nicegirls: Nice girls
SuddenlyGay: Suddenly Gay
palegirls: pale girls
Terraria: Terraria
AmateurRoomPorn: Amateur Room Porn
dogswithjobs: dogs with jobs
dontputyourdickinthat: dont put your dick in that
OSHA: OSHA
boobs: boobs
ScottishPeopleTwitter: Scottish People Twitter
NotMyJob: Not My Job
ExpectationVsReality: Expectation Vs Reality
selfimprovement: self improvement
environment: environment
AskOuija: Ask Ouija
dirtysmall: dirty small
freeuse: free use
PraiseTheCameraMan: Praise The Camera Man
RobinHood: Robin Hood
nsfwcosplay: nsfw cosplay
ofcoursethatsathing: of course thats a thing
Boobies: Boobies
dating: dating
lgbt: lgbt
AmongUs: Among Us
Hotwife: Hotwife
workgonewild: work gone wild
asstastic: asstastic
AnimalTextGifs: Animal Text Gifs
tiktokporn: tiktok porn
FloridaMan: Florida Man
worldbuilding: world building
Memes_Of_The_Dank: Memes Of The Dank
BokuNoHeroAcademia: Boku No Hero Academia
asoiaf: asoiaf
holdmyjuicebox: hold my juice box
startups: startups
antiMLM: anti MLM
agedlikemilk: aged like milk
Breath_of_the_Wild: Breath of the Wild
Autos: Autos
productivity: productivity
CityPorn: City Porn
talesfromtechsupport: tales from tech support
lego: lego
EngineeringPorn: Engineering Porn
FunnyandSad: Funny and Sad
grool: grool
creepyPMs: creepy PMs
TooCuteForPorn: Too Cute For Porn
cosplaygirls: cosplay girls
DadReflexes: Dad Reflexes
3Dprinting: 3D printing
povertyfinance: poverty finance
JusticePorn: Justice Porn
JoeRogan: Joe Rogan
OnePiece: One Piece
raisedbynarcissists: raised by narcissists
Gonewild18: Gonewild 18
mechanical_gifs: mechanical gifs
thick: thick
Stacked: Stacked
CrazyIdeas: Crazy Ideas
futurama: futurama
tooktoomuch: took too much
houseplants: houseplants
thanosdidnothingwrong: thanos did nothing wrong
MechanicAdvice: Mechanic Advice
DecidingToBeBetter: Deciding To Be Better
tippytaps: tippytaps
BigBoobsGW: Big Boobs GW
australia: australia
QuotesPorn: Quotes Porn
LearnUselessTalents: Learn Useless Talents
holdmyfries: hold my fries
TinyTits: Tiny Tits
WeWantPlates: We Want Plates
wholesomegifs: wholesome gifs
JerkOffToCelebs: Jerk Off To Celebs
NASCAR: NASCAR
NoahGetTheBoat: Noah Get The Boat
tennis: tennis
halo: halo
girlsinyogapants: girls in yoga pants
xsmallgirls: xsmall girls
homemadexxx: homemade xxx
suicidebywords: suicide by words
outside: outside
squirting: squirting
latinas: latinas
fantasyfootball: fantasy football
Piracy: Piracy
amateurcumsluts: amateur cum sluts
TheSilphRoad: The Silph Road
Meditation: Meditation
ArchitecturePorn: Architecture Porn
linux: linux
boottoobig: boot toobig
fitgirls: fit girls
notliketheothergirls: not like the other girls
Naruto: Naruto
AMA: AMA
IASIP: IASIP
InternetStars: Internet Stars
guns: guns
oddlyspecific: oddly specific
graphic_design: graphic design
chubby: chubby
shittyrobots: shitty robots
brooklynninenine: brooklyn nine nine
TalesFromRetail: Tales From Retail
NSFW411: NSFW411
SexInFrontOfOthers: Sex In Front Of Others
business: business
LeopardsAteMyFace: Leopards Ate My Face
SheLikesItRough: She Likes It Rough
watchpeoplesurvive: watch people survive
LateStageCapitalism: Late Stage Capitalism
britishproblems: british problems
PenmanshipPorn: Penmanship Porn
TwoSentenceHorror: Two Sentence Horror
bestoflegaladvice: best of legal advice
wallpapers: wallpapers
wifesharing: wife sharing
offbeat: offbeat
seduction: seduction
ColorizedHistory: Colorized History
nflstreams: nfl streams
woof_irl: woof irl
brasil: brasil
deepthroat: deep throat
combinedgifs: combined gifs
dontdeadopeninside: dont dead open inside
MorbidReality: Morbid Reality
altgonewild: alt gone wild
perfectloops: perfect loops
realestateinvesting: real estate investing
minimalism: minimalism
IllegalLifeProTips: Illegal Life Pro Tips
shortscarystories: short scary stories
sbubby: sbubby
Coffee: coffee
destiny2: destiny 2
Minecraftbuilds: Minecraft builds
GirlswithGlasses: Girls with Glasses
disneyvacation: disney vacation
asshole: asshole
paag: paag
shittymoviedetails: shitty movie details
gonewildaudio: gone wild audio
vinyl: vinyl
gentlemanboners: gentleman boners
jailbreak: jailbreak
StraightGirlsPlaying: Straight Girls Playing
elonmusk: elon musk
vegan: vegan
gonewildcurvy: gone wild curvy
Cyberpunk: Cyberpunk
Upskirt: Up skirt
StrangerThings: Stranger Things
geek: geek
polandball: poland ball
cumfetish: cum fetish
ihavesex: i have sex
creampies: creampies
sysadmin: sys admin
Celebs: Celebs
calvinandhobbes: calvin and hobbes
pussypassdenied: pussy pass denied
CatsStandingUp: Cats Standing Up
Cuckold: Cuckold
gettingherselfoff: getting herself off
StoppedWorking: Stopped Working
chemicalreactiongifs: chemical reaction gifs
france: france
EscapefromTarkov: Escape from Tarkov
tf2: tf2
PandR: P and R
bigtiddygothgf: big tiddy goth gf
tiktokthots: tiktok thots
2007scape: 2007 scape
redditgetsdrawn: reddit gets drawn
jacksepticeye: jack septiceye
ConvenientCop: Convenient Cop
HumansAreMetal: Humans Are Metal
engrish: engrish
curlyhair: curly hair
Patriots: Patriots
HadToHurt: Had To Hurt
nbastreams: nba streams
ABoringDystopia: A Boring Dystopia
pornvids: porn vids
2busty2hide: 2 busty 2 hide
CODWarzone: COD Warzone
lanarhoades: lana rhoades
ketorecipes: keto recipes
INEEEEDIT: INEEEEDIT
bodyperfection: body perfection
Moviesinthemaking: Movies in the making
Slut: slut
NSFWverifiedamateurs: NSFW verified amateurs
UrbanHell: Urban Hell
Baking: Baking
ThatLookedExpensive: That Looked Expensive
gamedev: game dev
CollegeAmateurs: College Amateurs
indianpeoplefacebook: indian people facebook
RobinHoodPennyStocks: Robin Hood Penny Stocks
AutoDetailing: Auto Detailing
comedyhomicide: comedy homicide
india: india
SquaredCircle: Squared Circle
blackpeoplegifs: black people gifs
quiver: quiver
NSFW_Snapchat: NSFW Snapchat
Simulated: Simulated
gonewildstories: gone wild stories
smallbusiness: small business
FUCKYOUINPARTICULAR: FUCK YOU IN PARTICULAR
headphones: headphones
summonerschool: summoner school
LSD: LSD
boobbounce: boob bounce
rearpussy: rear pussy
XboxSeriesX: Xbox Series X
youtube: youtube
FestivalSluts: Festival Sluts
OnlyFans101: Only Fans 101
help: help
Hotchickswithtattoos: Hot chicks with tattoos
tipofmypenis: tip of my penis
ginger: ginger
web_design: web design
GoCommitDie: Go Commit Die
birdswitharms: birds with arms
unitedkingdom: united kingdom
redheads: redheads
Advice: Advice
everymanshouldknow: every man should know
hugeboobs: huge boobs
lotr: lotr
ThingsCutInHalfPorn: Things Cut In Half Porn
CallOfDuty: Call Of Duty
Celebhub: Celeb hub
weed: weed
60fpsporn: 60 fps porn
CuteLittleButts: Cute Little Butts
Prematurecelebration: Premature celebration
SCP: SCP
AskCulinary: Ask Culinary
NoMansSkyTheGame: No Mans Sky The Game
gwcumsluts: gw cum sluts
MyPeopleNeedMe: My People Need Me
TrueCrime: True Crime
gonewildcouples: gone wild couples
ShingekiNoKyojin: Shingeki No Kyojin
WouldYouFuckMyWife: Would You Fuck My Wife
howtonotgiveafuck: how to not give a fuck
OldPhotosInRealLife: Old Photos In Real Life
PublicFlashing: Public Flashing
firstworldanarchists: first world anarchists
Brawlstars: Brawl Stars
AteTheOnion: Ate The Onion
gamernews: gamer news
TheDepthsBelow: The Depths Below
HugeDickTinyChick: Huge Dick Tiny Chick
Philippines: Philippines
FORTnITE: FORTnITE
delusionalartists: delusional artists
Catloaf: Catloaf
learnpython: learn python
economy: economy
Bad_Cop_No_Donut: Bad Cop No Donut
notinteresting: not interesting
donthelpjustfilm: dont help just film
CamSluts: Cam Sluts
traps: traps
IsItBullshit: Is It Bullshit
FIFA: FIFA
dirtyr4r: dirty r4r
cscareerquestions: cs career questions
pewdiepie: pewdiepie
Pareidolia: Pareidolia
Daytrading: Day trading
CombatFootage: Combat Footage
porn_gifs: porn gifs
theratio: the ratio
whatsthisplant: what's this plant
playstation: playstation
PersonalFinanceCanada: Personal Finance Canada
babyelephantgifs: baby elephant gifs
ZeroWaste: Zero Waste
TrueReddit: True Reddit
btc: btc
SluttyConfessions: Slutty Confessions
antimeme: anti meme
4PanelCringe: 4 Panel Cringe
TheWayWeWere: The Way We Were
Ebony: Ebony
gothsluts: goth sluts
bdsm: bdsm
ActualPublicFreakouts: Actual Public Freakouts
SandersForPresident: Sanders For President
darkjokes: dark jokes
creepypasta: creepy pasta
techsupportgore: tech support gore
facedownassup: face down ass up
2healthbars: 2 health bars
apolloapp: apollo app
AnalGW: Anal GW
Instantregret: Instant regret
Warframe: Warframe
KenM: Ken M
lostredditors: lost redditors
burstingout: bursting out
misleadingthumbnails: misleading thumbnails
absolutelynotme_irl: absolutely not me i rl
whenitgoesin: when it goes in
EmpireDidNothingWrong: Empire Did Nothing Wrong
ActLikeYouBelong: Act Like You Belong
HongKong: Hong Kong
fuckdoll: fuck doll
TumblrInAction: Tumblr In Action
finance: finance
shutupandtakemymoney: shut up and take my money
futanari: futa nari
findareddit: find a reddit
h3h3productions: h3h3 productions
Libertarian: Libertarian
xxfitness: xx fitness
CrackheadCraigslist: Crackhead Craigslist
NaughtyWives: Naughty Wives
JiggleFuck: Jiggle Fuck
hitmanimals: hitmanimals
AskRedditAfterDark: Ask Reddit After Dark
MonsterHunter: Monster Hunter
FashionReps: Fashion Reps
badwomensanatomy: bad womens anatomy
ClashRoyale: Clash Royale
rimjob_steve: rim job steve
community: community
OnePunchMan: One Punch Man
onlyfansgirls101: only fans girls 101
AnimeART: Anime ART
TheMonkeysPaw: The Monkeys Paw
IdiotsNearlyDying: Idiots Nearly Dying
ffxiv: ff xiv
jobs: jobs
VerticalGifs: Vertical Gifs
corgi: corgi
theocho: the ocho
datascience: data science
dndnext: dnd next
serialkillers: serial killers
SheFucksHim: She Fucks Him
Gamingcirclejerk: Gaming circle jerk
csgo: c s go
classicwow: classic wow
MonsterHunterWorld: Monster Hunter World
menwritingwomen: men writing women
Kanye: Kanye
PoliticalCompassMemes: Political Compass Memes
gwpublic: gw public
confidentlyincorrect: confidently incorrect
PremierLeague: Premier League
AccidentalRacism: Accidental Racism
college: college
RBI: RBI
SelfAwarewolves: Self Aware wolves
IRLEasterEggs: IRL Easter Eggs
nhaa: nhaa
standupshots: stand up shots
puns: puns
GooglePixel: Google Pixel
magicTCG: magic TCG
SlimThick: Slim Thick
Catswithjobs: Cats with jobs
dontyouknowwhoiam: dont you know who i am
tightdresses: tight dresses
Anxiety: Anxiety
pornID: porn ID
assholegonewild: asshole gone wild
RetroFuturism: Retro Futurism
DataHoarder: Data Hoarder
yoga: yoga
AnimeSketch: Anime Sketch
nocontextpics: no context pics
AppleWatch: Apple Watch
onejob: one job
disney: disney
Chonkers: Chonkers
booksuggestions: book suggestions
DCcomics: DC comics
succulents: succulents
RileyReid: Riley Reid
wikipedia: wikipedia
barelylegalteens: barely legal teens
WatchandLearn: Watch and Learn
FortniteCompetitive: Fortnite Competitive
architecture: architecture
de: de
CryptoMarkets: Crypto Markets
vexillology: vexillology
doctorwho: doctor who
simpleliving: simple living
circlejerk: circle jerk
SequelMemes: Sequel Memes
wholesomeanimemes: wholesome anime memes
civ: civ
Botchedsurgeries: Botched surgeries
patientgamers: patient gamers
Cursed_Images: Cursed Images
peopleofwalmart: people of walmart
dogpictures: dog pictures
beetlejuicing: beetle juicing
DadWouldBeProud: Dad Would Be Proud
creepyasterisks: creepy asterisks
thenetherlands: the netherlands
dashcamgifs: dash cam gifs
Exxxtras: Exxxtras
homegrowntits: homegrown tits
rupaulsdragrace: ru pauls drag race
MilitaryPorn: Military Porn
NotHowGirlsWork: Not How Girls Work
IllegallySmolCats: Illegally Smol Cats
shittysuperpowers: shitty superpowers
pathofexile: path of exile
beer: beer
bigtitsinbikinis: big tits in bikinis
BeforeNAfterAdoption: Before N After Adoption
happy: happy
jesuschristreddit: jesus christ reddit
Miakhalifa: Mia khalifa
gonewildcolor: gone wild color
olympics: olympics
DarkHumorAndMemes: Dark Humor And Memes
edmproduction: edm production
mexico: mexico
BonerMaterial: Boner Material
buttplug: butt plug
SubredditSimulator: Subreddit Simulator
FitNakedGirls: Fit Naked Girls
blackchickswhitedicks: black chicks white dicks
wholesomebpt: wholesome bpt
NeutralPolitics: Neutral Politics
InteriorDesign: Interior Design
SmashBrosUltimate: Smash Bros Ultimate
ghostnipples: ghost nipples
LabiaGW: Labia GW
Breadit: Breadit
KamikazeByWords: Kamikaze By Words
ufc: ufc
GoneMild: Gone Mild
O_Faces: O Faces
ItemShop: Item Shop
BoJackHorseman: Bo Jack Horseman
LearnJapanese: Learn Japanese
UnderwearGW: Underwear GW
thesims: the sims
canthold: canthold
suicidegirls: suicide girls
homelab: home lab
IndiansGoneWild: Indians Gone Wild
netsec: net sec
TrumpCriticizesTrump: Trump Criticizes Trump
RandomActsOfBlowJob: Random Acts Of Blow Job
13or30: 13 or 30
IndianBabes: Indian Babes
darksouls3: dark souls 3
redneckengineering: redneck engineering
DMAcademy: D M Academy
JustFriendsHavingFun: Just Friends Having Fun
NSFW_Japan: NSFW Japan
AsianNSFW: Asian NSFW
simps: simps
dbz: dbz
IRLgirls: IRL girls
rage: rage
1200isplenty: 1200 is plenty
booty_queens: booty queens
ArtPorn: Art Porn
couplesgonewild: couples gone wild
MakeNewFriendsHere: Make New Friends Here
TalesFromYourServer: Tales From Your Server
ecchi: ecchi
ThickThighs: Thick Thighs
DegradingHoles: Degrading Holes
creepyencounters: creepy encounters
deadbydaylight: dead by daylight
PropagandaPosters: Propaganda Posters
DnDBehindTheScreen: DnD Behind The Screen
PokemonSwordAndShield: Pokemon Sword And Shield
UnsentLetters: Unsent Letters
assassinscreed: assassins creed
musictheory: music theory
snapleaks: snap leaks
Thetruthishere: The truth is here
3amjokes: 3 am jokes
LosAngelesRams: Los Angeles Rams
r4r: r4r
thighdeology: thigh deology
MassiveCock: Massive Cock
RealPublicNudity: Real Public Nudity
AskScienceFiction: Ask Science Fiction
bimbofetish: bimbo fetish
AmateurPorn: Amateur Porn
cosplay: cosplay
slutwife: slut wife
languagelearning: language learning
SexyTummies: Sexy Tummies
Bondage: Bondage
GWNerdy: GW Nerdy
SatoshiStreetBets: Satoshi Street Bets
IWantToSuckCock: I Want To Suck Cock
Overwatch_Porn: Overwatch Porn
LucidDreaming: Lucid Dreaming
london: london
casualiama: casual iama
AssholeBehindThong: Asshole Behind Thong
StardustCrusaders: Stardust Crusaders
totallynotrobots: totally not robots
PublicSexPorn: Public Sex Porn
outrun: outrun
Doom: Doom
PixelArt: Pixel Art
WallStreetbetsELITE: Wall Street bets ELITE
Catswhoyell: cats who yell  
Stoicism: stoicism  
CODZombies: COD zombies  
tea: tea  
VaporwaveAesthetics: vaporwave aesthetics  
Buddhism: Buddhism  
StarWarsBattlefront: Star Wars Battlefront  
Warhammer40k: Warhammer 40k  
de_IAmA: de I Am A  
FantasyPL: fantasy PL  
bisexual: bisexual  
IndoorGarden: indoor garden  
NBA2k: NBA 2k  
raining: raining  
funsized: fun sized  
cumcoveredfucking: cum covered fucking  
realasians: real Asians  
RealAhegao: real Ahegao  
fasting: fasting  
blender: blender  
tech: tech  
TikTokNude: TikTok nude  
needadvice: need advice  
DarkAngels: dark angels  
EngineeringStudents: engineering students  
fo4: fo 4  
DepthHub: Depth Hub  
lingerie: lingerie  
ireland: Ireland  
FunWithFriends: fun with friends  
nsfwoutfits: NSFW outfits  
goodanimemes: good animemes  
BirdsArentReal: birds aren't real  
Aquariums: aquariums  
mildlypenis: mildly penis  
TheSimpsons: The Simpsons  
youdontsurf: you don't surf  
amateurgirlsbigcocks: amateur girls big cocks  
TalesFromTheFrontDesk: tales from the front desk  
ukpolitics: UK politics  
knitting: knitting  
theyknew: they knew  
GameTheorists: Game Theorists  
shittyreactiongifs: shitty reaction gifs  
Neverbrokeabone: never broke a bone  
Badfaketexts: bad fake texts  
googlehome: Google Home  
iamveryrandom: I am very random  
holdmycatnip: hold my catnip  
Superbowl: Super Bowl  
whatcouldgoright: what could go right  
submechanophobia: submechanophobia  
nocontext: no context  
borderlands3: borderlands 3  
popping: popping  
cookingforbeginners: cooking for beginners  
visualnovels: visual novels  
AccidentalWesAnderson: accidental Wes Anderson  
FacialFun: facial fun  
shockwaveporn: shockwave porn  
popheads: pop heads  
Animesuggest: anime suggest  
FemBoys: Fem Boys  
golf: golf  
engineering: engineering  
BBW: BBW  
Embroidery: embroidery  
awesome: awesome  
normalnudes: normal nudes  
Tgirls: T girls  
godtiersuperpowers: god tier superpowers  
dirtykikpals: dirty Kik pals  
DungeonsAndDragons: Dungeons And Dragons  
Windows10: Windows 10  
forwardsfromgrandma: forwards from grandma  
iwanttobeher: I want to be her  
cosplaybabes: cosplay babes  
trebuchetmemes: trebuchet memes  
batman: Batman  
MEOW_IRL: MEOW IRL  
whatsthisbug: what's this bug  
conspiracytheories: conspiracy theories  
Blep: blep  
chess: chess  
LongDistance: long distance  
CreditCards: credit cards  
damngoodinterracial: damn good interracial  
thedivision: the division  
skateboarding: skateboarding  
roblox: Roblox  
Sextrophies: sextrophies  
WorkOnline: work online  
TheMandalorianTV: The Mandalorian TV  
medicalschool: medical school  
HighResNSFW: high res NSFW  
HunterXHunter: Hunter X Hunter  
girlskissing: girls kissing  
BDSMGW: BDSM GW  
Seaofthieves: Sea of Thieves  
cordcutters: cord cutters  
MiaMalkova: Mia Malkova  
ComedyNecrophilia: comedy necrophilia  
whowouldwin: who would win  
tits: tits  
FrogButt: frog butt  
Innie: innie  
nukedmemes: nuked memes  
MarvelStudiosSpoilers: Marvel Studios spoilers  
RedditLaqueristas: Reddit Laqueristas  
tanlines: tan lines  
Handwriting: handwriting  
Sexsells: sex sells  
mallninjashit: mall ninja shit  
oculus: Oculus  
EDC: EDC  
IncelTears: Incel Tears  
ToiletPaperUSA: toilet paper USA  
Foodforthought: food for thought  
sex_comics: sex comics  
PLASTT: PLASTT  
doujinshi: doujinshi  
medicine: medicine  
ElderScrolls: Elder Scrolls  
nyc: NYC  
CitiesSkylines: Cities Skylines  
ApplyingToCollege: applying to college  
sewing: sewing  
Naturewasmetal: nature was metal  
excel: Excel  
PornStarletHQ: Porn Starlet HQ  
wtfstockphotos: WTF stock photos  
KitchenConfidential: Kitchen Confidential  
ItHadToBeBrazil: it had to be Brazil  
HighStrangeness: high strangeness  
comedynecromancy: comedy necromancy  
NuclearRevenge: nuclear revenge  
attackontitan: Attack on Titan  
KeanuBeingAwesome: Keanu Being Awesome  
dirtypenpals: dirty pen pals  
pyrocynical: pyrocynical  
happycowgifs: happy cow gifs  
NobodyAsked: nobody asked  
minipainting: mini painting  
socialism: socialism  
GTAV: GTA V  
budgetfood: budget food  
sweden: Sweden  
hometheater: home theater  
fatlogic: fat logic  
MangaCollectors: Manga Collectors  
Psychonaut: psychonaut  
minecraftsuggestions: Minecraft suggestions  
marketing: marketing  
UnsolvedMysteries: unsolved mysteries  
singapore: Singapore  
acturnips: AC Turnips  
Ultralight: ultralight  
DirtySnapchat: dirty Snapchat  
DnDGreentext: DnD greentext  
TheRightCantMeme: The Right Can't Meme  
FlashingAndFlaunting: flashing and flaunting  
FaceFuck: face fuck  
UKPersonalFinance: UK personal finance  
AskAnAmerican: ask an American  
forhonor: For Honor  
OTMemes: OT memes  
Satisfyingasfuck: satisfying as fuck  
LeagueOfMemes: League Of Memes  
fortyfivefiftyfive: forty five fifty five  
RepressedGoneWild: repressed gone wild  
veganrecipes: vegan recipes  
creampie: creampie  
GroupOfNudeGirls: group of nude girls  
UFOs: UFOs  
Colorization: colorization  
AskUK: ask UK  
HumanForScale: human for scale  
jilling: jilling  
CatsAreAssholes: cats are assholes  
ScarySigns: scary signs  
Makeup: makeup  
toronto: Toronto  
baconreader: bacon reader  
SpreadEm: spread em  
darksouls: Dark Souls  
COVID19: COVID 19  
SnowWhites: Snow Whites  
GoneWildSmiles: Gone Wild Smiles  
elderscrollsonline: elder scrolls online  
maturemilf: mature MILF  
gangbang: gangbang  
cardano: cardano  
homegym: home gym  
stripgirls: strip girls  
thighhighs: thigh highs  
GTAGE: GTA GE  
cleavage: cleavage  
MassiveTitsnAss: massive tits and ass  
absolutelynotmeirl: absolutely not me in real life  
happycrowds: happy crowds  
animememes: anime memes  
TeenBeauties: teen beauties  
restofthefuckingowl: rest of the fucking owl  
blackmirror: Black Mirror  
bustyasians: busty Asians  
gifsgonewild: gifs gone wild  
ifyoulikeblank: if you like blank  
ImaginaryLandscapes: imaginary landscapes  
happycryingdads: happy crying dads  
GoneWildTube: Gone Wild Tube  
beards: beards  
ClashOfClans: Clash Of Clans  
distension: distension
assinthong: assinthong
Repsneakers: Rep sneakers
Hololive: Hololive
pronebone: pronebone
PrettyGirls: Pretty Girls
toastme: toast me
actuallesbians: actual lesbians
gatesopencomeonin: gates open come on in
melbourne: melbourne
CuteModeSlutMode: Cute Mode Slut Mode
AskAcademia: Ask Academia
photoshop: photoshop
CringeAnarchy: Cringe Anarchy
reddeadredemption2: red dead redemption 2
ButtsAndBareFeet: Butts And Bare Feet
vaxxhappened: vaxxhappened
gravityfalls: gravity falls
Unashamed: Unashamed
shittyrainbow6: shitty rainbow 6
hardcoreaww: hardcore aww
Swingersgw: Swingers gw
knockmeup: knock me up
LofiHipHop: Lofi Hip Hop
WomenOfColor: Women Of Color
offlineTV: offline TV
BorednIgnored: Bored and Ignored
bigboye: bigboye
petite: petite
datingoverthirty: dating over thirty
StreetsIsWatchin: Streets Is Watchin
shrooms: shrooms
megalophobia: megalophobia
boltedontits: bolted on tits
WorldPacks: World Packs
Miniworlds: Miniworlds
PantiesToTheSide: Panties To The Side
MildlyVandalised: Mildly Vandalised
gifsthatendtoosoon: gifs that end too soon
SubwayCreatures: Subway Creatures
plantclinic: plant clinic
gundeals: gun deals
booty: booty
Ghosts: Ghosts
WhyEvenWearAnything: Why Even Wear Anything
randomsexiness: random sexiness
noisygifs: noisy gifs
The_Best_NSFW_GIFS: The Best NSFW GIFS
watchpeopledie: watch people die
womensstreetwear: womens streetwear
cameltoe: cameltoe
TattooDesigns: Tattoo Designs
adventuretime: adventure time
Borderlands: Borderlands
downblouse: downblouse
Pizza: Pizza
HotMoms: Hot Moms
YogaPants: Yoga Pants
HumanPorn: Human Porn
FrugalFemaleFashion: Frugal Female Fashion
LosAngeles: Los Angeles
Nipples: Nipples
Bundesliga: Bundesliga
AskEconomics: Ask Economics
GaybrosGoneWild: Gaybros Gone Wild
Nsfw_Amateurs: Nsfw Amateurs
PuppySmiles: Puppy Smiles
Military: Military
gainit: gain it
learnart: learn art
declutter: declutter
Tools: Tools
valheim: valheim
MURICA: MURICA
MasterReturns: Master Returns
ramen: ramen
datgap: datgap
CatTaps: Cat Taps
quotes: quotes
fakealbumcovers: fake album covers
pokemontrades: pokemon trades
whooties: whooties
awwwtf: awwwtf
EverythingScience: Everything Science
MonsterGirl: Monster Girl
unixporn: unix porn
breathinginformation: breathing information
BadMUAs: Bad MUAs
medizzy: medizzy
feedthebeast: feed the beast
40plusGoneWild: 40plus Gone Wild
Cartalk: Car talk
seethru: see thru
thingsforants: things for ants
HowToHack: How To Hack
vancouver: vancouver
pelfie: pelfie
DeadBedrooms: Dead Bedrooms
TheBoys: The Boys
warriors: warriors
AreTheStraightsOK: Are The Straights OK
gtaglitches: GTA glitches
Sims4: Sims 4
mycology: mycology
Persona5: Persona 5
BBCSluts: BBC Sluts
lewronggeneration: le wrong generation
TopMindsOfReddit: Top Minds Of Reddit
Breeding: Breeding
japan: japan
ShitAmericansSay: Shit Americans Say
Smite: Smite
ImaginaryMonsters: Imaginary Monsters
Sissies: Sissies
fo76: fo76
ErinAshford: Erin Ashford
RateMyNudeBody: Rate My Nude Body
gaybros: gay bros
italy: italy
LiverpoolFC: Liverpool FC
thickloads: thick loads
PreggoPorn: Preggo Porn
voluptuous: voluptuous
animegifs: anime gifs
PartyParrot: Party Parrot
pokies: pokies
MensRights: Mens Rights
MemeTemplatesOfficial: Meme Templates Official
AskDocs: Ask Docs
ChangingRooms: Changing Rooms
badeconomics: bad economics
seriouseats: serious eats
MuseumOfReddit: Museum Of Reddit
totalwar: total war
skyrimmods: skyrim mods
EntitledBitch: Entitled Bitch
beauty: beauty
HungryButts: Hungry Butts
tuckedinkitties: tucked in kitties
catsareliquid: cats are liquid
stevenuniverse: steven universe
tattoo: tattoo
pointlesslygendered: pointlessly gendered
Celebswithbigtits: Celebs with big tits
aliens: aliens
TrueFilm: True Film
spotify: spotify
marijuanaenthusiasts: marijuana enthusiasts
ich_iel: ich_iel
twerking: twerking
webcomics: web comics
CrusaderKings: Crusader Kings
AnimalsBeingGeniuses: Animals Being Geniuses
stupidslutsclub: stupid sluts club
streetwearstartup: streetwear startup
firstworldproblems: first world problems
extramile: extra mile
newzealand: new zealand
2000sGirls: 2000s Girls
texas: texas
WitchesVsPatriarchy: Witches Vs Patriarchy
BlowJob: Blow Job
traphentai: trap hentai
dogelore: doge lore
abelladanger: Abella Danger
HairyPussy: Hairy Pussy
passionx: passion x
FlashingGirls: Flashing Girls
CumHaters: Cum Haters
amateur_milfs: amateur milfs
socialanxiety: social anxiety
boxoffice: box office
GoneWildPlus: Gone Wild Plus
cuckquean: cuckquean
LadyBoners: Lady Boners
PokemonGoFriends: Pokemon Go Friends
lastimages: last images
litecoin: litecoin
lakers: lakers
CrackWatch: Crack Watch
hardbodies: hard bodies
Ifyouhadtopickone: If you had to pick one
reddevils: red devils
intel: intel
nsfw2: nsfw2
bertstrips: bert strips
BreadStapledToTrees: Bread Stapled To Trees
weightroom: weight room
blackopscoldwar: black ops cold war
wowthissubexists: wow this sub exists
Undertale: Undertale
raimimemes: raimi memes
GabbieCarter: Gabbie Carter
CelebrityPussy: Celebrity Pussy
drunk: drunk
AAAAAAAAAAAAAAAAA: AAAAAAAAAAAAAAAAA
Ripple: Ripple
nextdoorasians: next door asians
WomenBendingOver: Women Bending Over
suctiondildos: suction dildos
Rule34LoL: Rule34 LoL
Seattle: Seattle
stopdrinking: stop drinking
realmoms: real moms
Diablo: Diablo
playrust: play rust
Markiplier: Markiplier
monsterdicks: monster dicks
HotStuffNSFW: Hot Stuff NSFW
SexyFrex: Sexy Frex
Dogtraining: Dog training
TooMeIrlForMeIrl: Too Me Irl For Me Irl
DeadorVegetable: Dead or Vegetable
technews: tech news
careerguidance: career guidance
throatpies: throat pies
Xsome: X some
WaltDisneyWorld: Walt Disney World
geopolitics: geopolitics
formuladank: formula dank
subnautica: subnautica
thickwhitegirls: thick white girls
jobuds: jobuds
churning: churning
Mindfulness: Mindfulness
trashpandas: trash pandas
heroesofthestorm: heroes of the storm
EliteDangerous: Elite Dangerous
instantbarbarians: instant barbarians
fashion: fashion
snapchat_sluts: snapchat sluts
arduino: arduino
outercourse: outercourse
hardwareswap: hardware swap
cellbits: cell bits
manhwa: manhwa
GoneWildTrans: Gone Wild Trans
inthesoulstone: in the soul stone
startrek: star trek
FuckGaming: Fuck Gaming
landscaping: landscaping
PokePorn: Poke Porn
AngelaWhite: Angela White
imaginarymaps: imaginary maps
torontoraptors: toronto raptors
RedDeadOnline: Red Dead Online
Christianity: Christianity
Orgasms: Orgasms
NSFW_HTML5: NSFW HTML5
aa_cups: aa cups
GirlswithNeonHair: Girls with Neon Hair
chromeos: chrome os
vegetarian: vegetarian
functionalprint: functional print
coding: coding
BDSMcommunity: BDSM community
RimWorld: Rim World
GrandTheftAutoV: Grand Theft Auto V
WouldYouRather: Would You Rather
NSFW_Korea: NSFW Korea
StonerEngineering: Stoner Engineering
InsanePeopleQuora: Insane People Quora
Blackops4: Black ops 4
fantasywriters: fantasy writers
Marriage: Marriage
biggerthanherhead: bigger than her head
rule34_comics: rule34 comics
antiwork: anti work
blop: blop
Sidemen: Sidemen
MixedRaceGirls: Mixed Race Girls
AnimeFunny: Anime Funny
AutumnFalls: Autumn Falls
Anticonsumption: Anti consumption
AmazingCurves: Amazing Curves
fullmoviesonyoutube: full movies on youtube
Needafriend: Need a friend
SlyGifs: Sly Gifs
GoneWildScrubs: Gone Wild Scrubs
AccidentalComedy: Accidental Comedy
MinecraftMemes: Minecraft Memes
germany: germany
microgrowery: micro growery
NHLStreams: NHL Streams
Sabrina_Nichole: Sabrina Nichole
NintendoSwitchDeals: Nintendo Switch Deals
PornStarHQ: Porn Star HQ
starcraft: starcraft
collapse: collapse
CabinPorn: Cabin Porn
shitposting: shitposting
Competitiveoverwatch: Competitive Overwatch
ABraThatFits: A Bra That Fits
teefies: teefies
bayarea: bay area
SkincareAddicts: Skincare Addicts
TinyHouses: Tiny Houses
xbox: xbox
japanpics: japan pics
labrats: lab rats
criticalrole: critical role
StruggleFucking: Struggle Fucking
Sneks: Sneks
PS4Deals: PS4 Deals
FortniteLeaks: Fortnite Leaks
HobbyDrama: Hobby Drama
SuicideWatch: Suicide Watch
Stellaris: Stellaris
PacksLatinas: Packs Latinas
DiscordNudes: Discord Nudes
fitmeals: fit meals
argentina: argentina
girlswhoride: girls who ride
youngporn: young porn
roosterteeth: rooster teeth
ArcherFX: Archer FX
NostalgiaFapping: Nostalgia Fapping
NeckbeardNests: Neckbeard Nests
LetsTalkMusic: Lets Talk Music
painting: painting
fivenightsatfreddys: five nights at freddys
runescape: runescape
HermitCraft: Hermit Craft
statistics: statistics
arresteddevelopment: arrested development
forcedorgasms: forced orgasms
BadDragon: Bad Dragon
ahegao: ahegao
onions: onions
wholesomegreentext: wholesome greentext
Cricket: Cricket
OnlyFansPromotions: Only Fans Promotions
NudeCelebsOnly: Nude Celebs Only
FinalFantasy: Final Fantasy
bjj: bjj
ACTrade: AC Trade
AccidentalCamouflage: Accidental Camouflage
SapphoAndHerFriend: Sappho And Her Friend
cumshots: cumshots
ontario: ontario
fireemblem: fire emblem
skinnytail: skinny tail
toolporn: tool porn
BeautyGuruChatter: Beauty Guru Chatter
Nootropics: Nootropics
brushybrushy: brushy brushy
BigBoobsGonewild: Big Boobs Gonewild
techsupportmacgyver: tech support macgyver
CampingGear: Camping Gear
BelleDelphinePatreon: Belle Delphine Patreon
raidsecrets: raid secrets
WeatherGifs: Weather Gifs
askgaybros: ask gay bros
Thisismylifemeow: This is my life meow
GME: GME
TalesFromTheCustomer: Tales From The Customer
GodAsshole: God Asshole
OverwatchUniversity: Overwatch University
boston: boston
Guildwars2: Guild wars 2
deepweb: deep web
Battlefield: Battlefield
Rainmeter: Rainmeter
blowjobsandwich: blow job sandwich
hentaibondage: hentai bondage
sexygirls: sexy girls
slutsofsnapchat: sluts of snapchat
wokekids: woke kids
chicago: chicago
SocialMediaSluts: Social Media Sluts
betterCallSaul: better Call Saul
smallboobs: small boobs
curledfeetsies: curled feetsies
MLBStreams: MLB Streams
smoking: smoking
BitcoinBeginners: Bitcoin Beginners
stockings: stockings
TechNewsToday: Tech News Today
introvert: introvert
AsianCuties: Asian Cuties
transporn: trans porn
Adult_Social_Network: Adult Social Network
MUAontheCheap: MUA on the Cheap
WhatsWrongWithYourCat: What's Wrong With Your Cat
GTAorRussia: GTA or Russia
hiphop101: hip hop 101
ac_newhorizons: ac new horizons
mangaswap: manga swap
occult: occult
titfuck: tit fuck
90DayFiance: 90 Day Fiance
PhotoshopRequest: Photoshop Request
horny: horny
18nsfw: 18 nsfw
WesternHentai: Western Hentai
Skincare_Addiction: Skincare Addiction
IncestPorn: Incest Porn
RealLifeShinies: Real Life Shinies
bloodborne: bloodborne
ladybonersgw: lady boners gw
EconomicHistory: Economic History
amazingtits: amazing tits
thanksihateit: thanks i hate it
coaxedintoasnafu: coaxed into a snafu
burdurland: burdurland
BubbleButts: Bubble Butts
anime_titties: anime titties
eatsandwiches: eat sandwiches
ShitMomGroupsSay: Shit Mom Groups Say
powerlifting: powerlifting
barkour: barkour
emulation: emulation
PrettyLittleCumsluts: Pretty Little Cumsluts
AsianPorn: Asian Porn
nothingeverhappens: nothing ever happens
titanfall: titanfall
boomershumor: boomers humor
RealEstate: Real Estate
Polska: Polska
JonWinsTheThrone: Jon Wins The Throne
killthecameraman: kill the cameraman
JapanesePorn2: Japanese Porn 2
AntiJokes: Anti Jokes
MasterOfAnal: Master Of Anal
knives: knives
public: public
askwomenadvice: ask women advice
BreastEnvy: Breast Envy
SlimandStacked: Slim and Stacked
naturaltitties: natural titties
DC_Cinematic: DC Cinematic
JordanPeterson: Jordan Peterson
BeautifulFemales: Beautiful Females
reactjs: react js
AskEurope: Ask Europe
Hair: Hair
TheRedPill: The Red Pill
whatintarnation: what in tarnation
LatinasGW: Latinas GW
dykesgonewild: dykes gone wild
ipad: iPad
unstirredpaint: unstirred paint
TheRealJoke: The Real Joke
Threesome: Threesome
Angryupvote: Angry upvote
GamersRiseUp: Gamers Rise Up
grilledcheese: grilled cheese
notlikeothergirls: not like other girls
lawncare: lawn care
Hulu: Hulu
Turkey: Turkey
DaughterTraining: Daughter Training
JustHotWomen: Just Hot Women
cheatingwives: cheating wives
arabfunny: arab funny
facesitting: face sitting
Scams: Scams
instantpot: instant pot
hiphopvinyl: hip hop vinyl
yiff: yiff
Unity3D: Unity 3D
eu4: eu 4
RedditSessions: Reddit Sessions
amv: amv
StreetFights: Street Fights
cybersecurity: cyber security
ImaginarySliceOfLife: Imaginary Slice Of Life
cableporn: cable porn
keming: keming
HitBoxPorn: Hit Box Porn
androidapps: android apps
cosplayprops: cosplay props
FullScorpion: Full Scorpion
GirlsShowering: Girls Showering
gay: gay
afkarena: afk arena
TrueCrimeDiscussion: True Crime Discussion
ACQR: ACQR
bostonceltics: boston celtics
scriptedasiangifs: scripted asian gifs
democrats: democrats
linguistics: linguistics
binance: binance
DigitalPainting: Digital Painting
onebag: one bag
wowthanksimcured: wow thanks, I'm cured
prettyaltgirls: pretty alt girls
Iamactuallyverybadass: I am actually very badass
malegrooming: male grooming
Lesbian_gifs: Lesbian gifs
shorthairchicks: short hair chicks
resumes: resumes
Pegging: Pegging
Femdom: Femdom
worldcup: world cup
TikThots: Tik Thots
badhistory: bad history
HelpMeFind: Help Me Find
delusionalcraigslist: delusional craigslist
ThickChixxx: Thick Chixxx
WildernessBackpacking: Wilderness Backpacking
Shemales: Shemales
Drumkits: Drum kits
PetTheDamnDog: Pet The Damn Dog
masseffect: mass effect
mbti: mbti
Overwatch_Memes: Overwatch Memes
titsonastick: Tits on a stick
BabyBumps: Baby Bumps
iWantToFuckHer: I want to fuck her
danganronpa: danganronpa
TrueAskReddit: True Ask Reddit
obsf: obsf
gamegrumps: game grumps
Old_Recipes: Old Recipes
FrankOcean: Frank Ocean
TheGirlSurvivalGuide: The Girl Survival Guide
torpedotits: torpedo tits
starcitizen: star citizen
HeavySeas: Heavy Seas
FreeGamesOnSteam: Free Games On Steam
GirlsOnTop: Girls On Top
StreamersGoneWild: Streamers Gone Wild
Disneyland: Disneyland
FREE: FREE
beholdthemasterrace: behold the master race
catpranks: cat pranks
Spiderman: Spiderman
STAWG: STAWG
AnimeMusicVideos: Anime Music Videos
gif: gif
crossfit: crossfit
AdrianaChechik: Adriana Chechik
Oilporn: Oil porn
ARK: ARK
MurderedByAOC: Murdered By AOC
castiron: cast iron
AgedBeauty: Aged Beauty
glitch_art: glitch art
AlexaPearl: Alexa Pearl
rapbattles: rap battles
YouTubersGoneWild: YouTubers Gone Wild
bulletjournal: bullet journal
HomeDecorating: Home Decorating
FancyFollicles: Fancy Follicles
traaaaaaannnnnnnnnns: trans
IndieGaming: Indie Gaming
starwarsmemes: Star Wars memes
behindthegifs: behind the gifs
feetpics: feet pics
youtubetitties: youtube titties
factorio: factorio
TotallyStraight: Totally Straight
hoi4: hoi4
mentalhealth: mental health
ImaginaryLeviathans: Imaginary Leviathans
Punny: Punny
MortalKombat: Mortal Kombat
answers: answers
virtualreality: virtual reality
OneSecondBeforeDisast: One Second Before Disaster
HentaiBeast: Hentai Beast
NSFW_Plowcam: NSFW Plowcam
EngorgedVeinyBreasts: Engorged Veiny Breasts
leggingsgonewild: leggings gone wild
hmm: hmm
DesirePath: Desire Path
grandorder: grand order
LenaPaul: Lena Paul
WtSSTaDaMiT: Wt SSTa DaMiT
trapproduction: trap production
sushi: sushi
BobsBurgers: Bob's Burgers
networking: networking
Blonde: Blonde
place: place
OldSchoolCoolNSFW: Old School Cool NSFW
Pornheat: porn heat
wincest: wincest
BoobsAndTities: Boobs And Tities
anal_gifs: anal gifs
weeaboo: weeaboo
crochet: crochet
Romania: Romania
electronics: electronics
asmr: ASMR
thegrandtour: the grand tour
osugame: osu game
JustBootThings: Just Boot Things
saiyanpeopletwitter: saiyan people twitter
AwesomeCarMods: Awesome Car Mods
AnimeMILFS: Anime MILFS
HollowKnight: Hollow Knight
GoneErotic: Gone Erotic
AskElectronics: Ask Electronics
witchcraft: witchcraft
EvaElfie: Eva Elfie
ProperAnimalNames: Proper Animal Names
smalltitsbigass: small tits big ass
OculusQuest: Oculus Quest
THE_PACK: THE PACK
AskEngineers: Ask Engineers
creampiegifs: creampie gifs
freelance: freelance
Accounting: Accounting
GirlsHumpingThings: Girls humping things
GetStudying: Get Studying
Ersties: Ersties
Teachers: Teachers
TopGear: Top Gear
FL_Studio: FL Studio
cocktails: cocktails
Milfie: Milfie
TeamfightTactics: Teamfight Tactics
futbol: futbol
japanlife: japan life
nhl: nhl
preppers: preppers
philadelphia: philadelphia
Porndio: Porndio
animalsdoingstuff: animals doing stuff
TwinGirls: Twin Girls
MLS: MLS
slavelabour: slave labour
Workoutgonewild: Workout gone wild
projectcar: project car
java: java
badtattoos: bad tattoos
malehairadvice: male hair advice
Fingering: Fingering
TributeMe: Tribute Me
InclusiveOr: Inclusive Or
sanfrancisco: San Francisco
animenocontext: anime no context
ChristianGirls: Christian Girls
RemyLaCroix: Remy LaCroix
FragileWhiteRedditor: Fragile White Redditor
astrology: astrology
Konosuba: Konosuba
BreakingTheSeal: Breaking The Seal
femalepov: female pov
sydney: sydney
KingdomHearts: Kingdom Hearts
SexyButNotPorn: Sexy But Not Porn
Afrodisiac: Afrodisiac
forhire: for hire
smoobypost: smooby post
byebyejob: bye bye job
amiugly: am i ugly
Atlanta: Atlanta
sexstories: sex stories
confidence: confidence
millionairemakers: millionaire makers
lingling40hrs: lingling40hrs
motivation: motivation
Doggystyle_NSFW: Doggystyle NSFW
MTB: MTB
ratemyboobs: rate my boobs
imveryedgy: i'm very edgy
titanfolk: titanfolk
Austin: Austin
PUBG: PUBG
facebookwins: facebook wins
splatoon: splatoon
learnmachinelearning: learn machine learning
StupidFood: Stupid Food
LatinaCuties: Latina Cuties
piano: piano
furry: furry
scarystories: scary stories
Cawwsplay: Cawws play
pussyrating: pussy rating
radiohead: radiohead
yugioh: yugioh
audioengineering: audio engineering
smallstreetbets: small street bets
CatSlaps: Cat Slaps
treesgonewild: trees gone wild
needysluts: needy sluts
gayporn: gay porn
findfashion: find fashion
BattlefieldV: Battlefield V
exposedinpublic: exposed in public
overclocking: overclocking
PlayStationPlus: PlayStation Plus
appletv: apple tv
gonewildchubby: gone wild chubby
Ooer: Ooer
AthleticBabes: Athletic Babes
hbo: hbo
forza: forza
CatsMurderingToddlers: Cats Murdering Toddlers
ableton: ableton
dailyprogrammer: daily programmer
Incorgnito: Incorgnito
FreeGameFindings: Free Game Findings
Watercolor: Watercolor
leangains: leangains
AndroidGaming: Android Gaming
MovieSuggestions: Movie Suggestions
indie: indie
OkCupid: Ok Cupid
PupliftingNews: Puplifting News
learnmath: learn math
ThrobbingCIM: Throbbing CIM
WhiteCheeks: White Cheeks
porninaminute: porn in a minute
FauxBait: Faux Bait
cock: cock
LegalAdviceUK: Legal Advice UK
GachaLifeCringe: Gacha Life Cringe
houston: houston
Swingers: Swingers
snapchat: snapchat
chelseafc: chelsea fc
flexibility: flexibility
piercing: piercing
Sexy: Sexy
woosh: woosh
secretsanta: secret santa
Playboy: Playboy
China: China
Paladins: Paladins
WhyWomenLiveLonger: Why Women Live Longer
BrownHotties: Brown Hotties
PhonesAreBad: Phones Are Bad
ArtFundamentals: Art Fundamentals
SommerRay: Sommer Ray
gorillaz: gorillaz
chickflixxx: chick flixxx
bigdickgirl: big dick girl
FinancialPlanning: Financial Planning
TessaFowler: Tessa Fowler
dayz: dayz
PeopleBeingJerks: People Being Jerks
Naruto_Hentai: Naruto Hentai
Idubbbz: I dubbbz
Puffies: Puffies
dadswhodidnotwantpets: dads who did not want pets
RandomActsOfMuffDive: Random Acts Of Muff Dive
itsaunixsystem: it's a unix system
Mommit: Mommit
DontFundMe: Don't Fund Me
PremiumCheeks: Premium Cheeks
MasturbationGoneWild: Masturbation Gone Wild
nope: nope
battlefield_one: battlefield one
futureporn: future porn
OralCreampie: Oral Creampie
talesfromcallcenters: tales from call centers
snapchat_nudes: snapchat nudes
CryptoMoonShots: Crypto Moon Shots
NotHowDrugsWork: Not How Drugs Work
linuxmasterrace: linux master race
wholesomejojo: wholesome jojo
kpopfap: kpop fap
PantyPeel: Panty Peel
California: California
Dildo_Gifs: Dildo Gifs
steamdeals: steam deals
NewTubers: New Tubers
oneplus: one plus
Warhammer: Warhammer
Dreams: Dreams
ebonyamateurs: ebony amateurs
FapDungeons: Fap Dungeons
acne: acne
weedstocks: weed stocks
bangtan: bangtan
FreeKarma4U: Free Karma 4 U
airpods: airpods
sportsbook: sportsbook
eagles: eagles
FilthyGirls: Filthy Girls
Warthunder: Warthunder
MedicalGore: Medical Gore
legs: legs
nursing: nursing
SchoolGirlSkirts: School Girl Skirts
hmmmgifs: hmmmgifs
daddit: daddit
GoodGirlsSwallow: Good Girls Swallow
SloppyBlowjob: Sloppy Blowjob
DrunkDrunkenPorn: Drunk Drunken Porn
rant: rant
GlobalOffensiveTrade: Global Offensive Trade
penis: penis
RealHomePorn: Real Home Porn
gaymers: gaymers
ImaginaryTechnology: Imaginary Technology
AmateurPornVids: Amateur Porn Vids
asiangirlswhitecocks: asian girls white cocks
bigareolas: big areolas
Feminism: Feminism
lonely: lonely
Monero: Monero
Roughanal: Rough Anal
MagicArena: Magic Arena
NintendoWaifus: Nintendo Waifus
animation: animation
UnexpectedThugLife: Unexpected Thug Life
wetspot: wetspot
painal: painal
mountandblade: mount and blade
Anarchism: Anarchism
LatinoPeopleTwitter: Latino People Twitter
Bonsai: Bonsai
dvdcollection: dvd collection
sousvide: sous vide
xxxcaptions: xxx captions
Letterkenny: Letterkenny
braceface: brace face
ketoscience: keto science
CelebrityButts: Celebrity Butts
onmww: onmww
Titties: Titties
NakedAdventures: Naked Adventures
creepydesign: creepy design
omgbeckylookathiscock: omg becky look at his cock
WeddingsGoneWild: Weddings Gone Wild
ShemalesParadise: Shemales Paradise
AvaAddams: Ava Addams
IncreasinglyVerbose: Increasingly Verbose
cumonclothes: cum on clothes
AdrenalinePorn: Adrenaline Porn
BestPornInGalaxy: Best Porn In Galaxy
TwitchGoneWild: Twitch Gone Wild
spirituality: spirituality
amibeingdetained: am i being detained
yuri: yuri
CallOfDutyMobile: Call Of Duty Mobile
YouSeeComrade: You See Comrade
nudesfeed: nudes feed
MandelaEffect: Mandela Effect
KDRAMA: KDRAMA
bi_irl: bi irl
BeautyBoxes: Beauty Boxes
Wellworn: Well Worn
feet: feet
ar15: ar15
pickuplines: pick up lines
JapanUncensored: Japan Uncensored
15minutefood: 15 minute food
CrossStitch: Cross Stitch
plotholes: plot holes
Vaporwave: Vaporwave
findapath: find a path
LiyaSilver: Liya Silver
espresso: espresso
DMT: DMT
dark_humor: dark humor
Berserk: Berserk
malefashion: male fashion
ProtectAndServe: Protect and Serve
MrRobot: Mr. Robot
Portland: Portland
Amoledbackgrounds: Amoled Backgrounds
Flipping: Flipping
windows: windows
Jazz: Jazz
Frisson: Frisson
WastedGifs: Wasted Gifs
VerifiedAmateurs: Verified Amateurs
BBQ: BBQ
hotclub: hot club
electronic_cigarette: electronic cigarette
Humanoidencounters: Humanoid Encounters
babybigcatgifs: baby big cat gifs
cursedvideos: cursed videos
funhaus: funhaus
FastWorkers: Fast Workers
Catculations: Catculations
characterdrawing: character drawing
lactation: lactation
forcedcreampie: forced creampie
thick_hentai: thick hentai
Marijuana: Marijuana
Evalovia: Evalovia
InfrastructurePorn: Infrastructure Porn
ApexOutlands: Apex Outlands
Grimdank: Grimdank
shortcuts: shortcuts
morbidquestions: morbid questions
ProductPorn: Product Porn
Denmark: Denmark
bikinis: bikinis
PiercedNSFW: Pierced NSFW
ThotClub: Thot Club
hentaimemes: hentai memes
Giraffesdontexist: Giraffes don't exist
tarot: tarot
MineralPorn: Mineral Porn
residentevil: resident evil
DBZDokkanBattle: DBZ Dokkan Battle
cycling: cycling
BotanicalPorn: Botanical Porn
blackdesertonline: black desert online
besthqporngifs: best hq porn gifs
bindingofisaac: binding of isaac
rpghorrorstories: RPG horror stories
HugeHangers: Huge Hangers
WalmartCelebrities: Walmart Celebrities
BitcoinMarkets: Bitcoin Markets
GamingDetails: Gaming Details
30PlusSkinCare: 30 Plus Skin Care
mechmarket: mechmarket
ratemycock: ratemycock
WWE: WWE
SkyPorn: Sky Porn
minecraftseeds: minecraftseeds
HailCorporate: Hail Corporate
Forex: Forex
MoviePosterPorn: Movie Poster Porn
VoyeurFlash: Voyeur Flash
orochinho: orochinho
AquaticAsFuck: Aquatic As Fuck
ConfusedBoners: Confused Boners
ElsaJean: Elsa Jean
braless: braless
hipcleavage: hip cleavage
pan: pan
AvatarMemes: Avatar Memes
Tentai: Tentai
MiddleEasternHotties: Middle Eastern Hotties
femalehairadvice: female hair advice
Scary: Scary
ZenHabits: Zen Habits
polyamory: polyamory
Davie504: Davie504
TrueFMK: TrueFMK
paradoxplaza: paradoxplaza
AnimalsOnReddit: Animals On Reddit
retrogaming: retro gaming
twinks: twinks
VideoEditing: Video Editing
ShinyPorn: Shiny Porn
thecatdimension: the cat dimension
buttsthatgrip: butts that grip
thelastofus: the last of us
samsung: samsung
asianpeoplegifs: asian people gifs
Gloryholes: Gloryholes
Houseporn: House porn
trailerparkboys: trailer park boys
PlantedTank: Planted Tank
Ohlympics: Ohlympics
scrubsgonewild: scrubs gone wild
CelebsBR: CelebsBR
GreenBayPackers: Green Bay Packers
DaniDaniels: Dani Daniels
UnusAnnus: Unus Annus
footballmanagergames: football manager games
TargetedShirts: Targeted Shirts
ketogains: ketogains
camwhores: camwhores
Layer: Layer
cosplaybutts: cosplay butts
aves: aves
CosplayBoobs: Cosplay Boobs
GoneWildHairy: Gone Wild Hairy
SupermodelCats: Supermodel Cats
exmormon: exmormon
pizzadare: pizzadare
XRP: XRP
teenspornvideos: teens porn videos
196: 196
awfuleyebrows: awful eyebrows
awwnime: awwnime
modnews: mod news
spreading: spreading
sportsarefun: sports are fun
bigdickproblems: big dick problems
cinematography: cinematography
Rabbits: Rabbits
Animewallpaper: Anime wallpaper
lostgeneration: lost generation
SpaceXLounge: Space XLounge
CallMeCarson: Call Me Carson
Pornhub: Pornhub
TwoRedditorsOneCup: Two Redditors One Cup
ExposedToStrangers: Exposed To Strangers
Just18: Just 18
grilling: grilling
strength_training: strength training
PanPorn: Pan Porn
BitedSizeSexy: Bited Size Sexy
PussyMound: Pussy Mound
Cheap_Meals: Cheap Meals
TankPorn: Tank Porn
subaru: subaru
wholesomehentai: wholesome hentai
fountainpens: fountain pens
Dogberg: Dogberg
KarmaCourt: Karma Court
premed: premed
SexyFlowerWater: Sexy Flower Water
GifsOfRemoval: Gifs Of Removal
communism: communism
Kombucha: Kombucha
AmateurSlutWives: Amateur Slut Wives
newjersey: new jersey
Thicker: Thicker
LiminalSpace: Liminal Space
girlsdoingstuffnaked: girls doing stuff naked
leanfire: leanfire
ExpandDong: Expand Dong
Superstonk: Superstonk
thanksimcured: thanks im cured
TotalBabes: Total Babes
joi: joi
Gunners: Gunners
EraserNipples: Eraser Nipples
AusFinance: AusFinance
JessicaNigri: Jessica Nigri
ItsAmateurHour: Its Amateur Hour
BlowjobGirls: Blowjob Girls
ObscureMedia: Obscure Media
AstralProjection: Astral Projection
tommyinnit: tommyinnit
typography: typography
DecreasinglyVerbose: Decreasingly Verbose
depression_memes: depression memes
PunPatrol: Pun Patrol
xqcow: xqcow
horrorlit: horrorlit
pulsatingcumshots: pulsating cumshots
wifepictrading: wife pic trading
Lovecraft: Lovecraft
FlubTrash: Flub Trash
soccerstreams: soccer streams
FallGuysGame: Fall Guys Game
streetphotography: street photography
MoundofVenus: Mound of Venus
spreadeagle: spread eagle
synthesizers: synthesizers
German: German
apexuniversity: apex university
airsoft: airsoft
memesITA: memes ITA
Tendies: Tendies
HIMYM: HIMYM
SiegeAcademy: Siege Academy
Nike: Nike
CFBStreams: CFBStreams
doublepenetration: double penetration
buildapcforme: build a pc for me
MiaMelano: Mia Melano
devops: devops
PAWGSluts: PAWG Sluts
orgasmcontrol: orgasm control
pornfree: porn free
diablo3: diablo 3
RuinedOrgasms: Ruined Orgasms
iiiiiiitttttttttttt: iiiiit
throatbarrier: throat barrier
ImaginaryCharacters: Imaginary Characters
thiccerthanyouthought: thiccer than you thought
metalgearsolid: metal gear solid
seinfeld: seinfeld
node: node
football: football
orslokx: orslokx
Calgary: Calgary
Denver: Denver
dndmaps: dnd maps
speedrun: speedrun
52book: 52book
Assistance: Assistance
Incest_Gifs: Incest Gifs
DreamWasTaken: Dream Was Taken
GlitchInTheMatrix: Glitch In The Matrix
Bushcraft: Bushcraft
korea: korea
pelotoncycle: peloton cycle
GirlsMirin: Girls Mirin
BikiniBodies: Bikini Bodies
DIYUK: DIY UK
playboicarti: playboicarti
guitarlessons: guitar lessons
makinghiphop: making hiphop
LegalTeensXXX: Legal Teens XXX
AlienBlue: Alien Blue
UnnecessaryInventions: Unnecessary Inventions
HelplessHentai: Helpless Hentai
EllieLeen: Ellie Leen
unexpectedtitty: unexpected titty
ClassyPornstars: Classy Pornstars
DarkJokeCentral: Dark Joke Central
BMW: BMW
OutdoorRecreation: Outdoor Recreation
moderatepolitics: moderate politics
wicked_edge: wicked edge
collared: collared
sixers: sixers
DDLC: DDLC
GradSchool: Grad School
humblebrag: humble brag
footballhighlights: football highlights
BDSMAdvice: BDSM Advice
blackcats: black cats
CongratsLikeImFive: Congrats Like Im Five
Nails: Nails
Welding: Welding
screenshots: screenshots
PleX: PleX
computerscience: computer science
POV: POV
deals: deals
DesignMyRoom: Design My Room
RetrousseTits: Retrousse Tits
xboxinsiders: xbox insiders
Squatfuck: Squatfuck
FitAndNatural: Fit And Natural
OnHerKnees: On Her Knees
IncestGifs: Incest Gifs
evangelion: evangelion
Models: Models
classic4chan: classic 4chan
geekygirls: geeky girls
DesignerReps: Designer Reps
Birbs: Birbs
legendofkorra: legend of korra
emogirls: emo girls
Brogress: Brogress
GoodFakeTexts: Good Fake Texts
Imposter: Imposter
HomeNetworking: Home Networking
OnlyIfShesPackin: Only If Shes Packin
nsfw_wtf: nsfw wtf
facial: facial
Ratemypussy: Rate my pussy
modelmakers: model makers
indie_rock: indie rock
HaircareScience: Haircare Science
sissyhypno: sissy hypno
Shoes: Shoes
Sekiro: Sekiro
2meirl42meirl4meirl: 2meirl42meirl4meirl
Firtsbornunicorn: Firtsbornunicorn
Bottomless_Vixens: Bottomless Vixens
TIGHTPUSSY: TIGHTPUSSY
titstouchingtits: tits touching tits
momsgonewild: moms gone wild
awakened: awakened
AskMenOver30: Ask Men Over 30
starwarsnsfw: star wars nsfw
Bukkake: Bukkake
SpitRoasted: Spit Roasted
sarah_xxx: sarah_xxx
Michigan: Michigan
HadesTheGame: Hades The Game
DankMemesFromSite19: Dank Memes From Site 19
halloween: halloween
TheGoodPlace: The Good Place
PublicFuckTube: Public Fuck Tube
Sexydesibabes: Sexy Desi Babes
cpp: cpp
linux_gaming: linux gaming
celebsnaked: celebs naked
meatcrayon: meatcrayon
PalaceClothing: Palace Clothing
hugenaturals: huge naturals
MinecraftCommands: Minecraft Commands
LingerieGW: LingerieGW
entitledparentsmemes: entitled parents memes
IndianTeens: Indian Teens
logodesign: logo design
Duklock: Duklock
miniminter: miniminter
Missing411: Missing411
Splitview: Splitview
PlantBasedDiet: Plant Based Diet
dildo: dildo
swingersr4r: swingers r4r
CryptoCurrencies: Crypto Currencies
Instagram: Instagram
weddingshaming: wedding shaming
FinancialCareers: Financial Careers
RocketLeagueExchange: Rocket League Exchange
leaves: leaves
TheBullWins: The Bull Wins
FondantHate: Fondant Hate
skamtebord: skamtebord
bootypetite: booty petite
BlowjobGifs: Blowjob Gifs
bigonewild: big one wild
bourbon: bourbon
whiskey: whiskey
FullmetalAlchemist: Fullmetal Alchemist
gentlefemdom: gentle femdom
GarlicBreadMemes: Garlic Bread Memes
Dallas: Dallas
nakedgirlsdancing: naked girls dancing
Supplements: Supplements
army: army
selfie: selfie
gamingpc: gaming pc
distantsocializing: distant socializing
AdultNeeds: Adult Needs
spicy: spicy
usedpanties: used panties
GunPorn: Gun Porn
OnStageGW: On Stage GW
linuxquestions: linux questions
WANDAVISION: Wanda Vision
Rateme: Rate me
simracing: sim racing
MouseReview: Mouse Review
archlinux: arch linux
HFY: HFY
CosplayLewd: Cosplay Lewd
Sat: Sat
TheoryOfReddit: Theory Of Reddit
religiousfruitcake: religious fruitcake
NataLee: Nata Lee
NSFW_Social: NSFW Social
Austria: Austria
AskPhotography: Ask Photography
PiratedGames: Pirated Games
BokuNoEroAcademia: Boku No Ero Academia
haikyuu: haikyuu
askphilosophy: ask philosophy
NotSafeForNature: Not Safe For Nature
awardtravel: award travel
bouldering: bouldering
bitchimabus: bitch I'm a bus
coloringcorruptions: coloring corruptions
beachgirls: beach girls
GreatView: great view
PickOne: pick one
Shadman: Shadman
DarkNetMarkets: Dark Net Markets
emojipasta: emoji pasta
StoriesAboutKevin: Stories About Kevin
tombstoning: tombstoning
hopelesssofrantic: hopeless so frantic
PUBGMobile: PUBG Mobile
FireEmblemHeroes: Fire Emblem Heroes
swedishproblems: swedish problems
nsfw_videos: NSFW videos
EntitledPeople: Entitled People
orgasmiccontractions: orgasmic contractions
DeliciousTraps: delicious traps
UnearthedArcana: Unearthed Arcana
egg_irl: egg irl
MomForAMinute: Mom For A Minute
MedievalCats: Medieval Cats
5050: 5050
CanadianInvestor: Canadian Investor
Bass: Bass
TheYouShow: The You Show
NSFWIAMA: NSFW IAMA
DarkSouls2: Dark Souls 2
playark: play ark
LightNovels: Light Novels
Ubuntu: Ubuntu
treedibles: tree edibles
Psychic: Psychic
Supernatural: Supernatural
freeusefamily: free use family
BoringCompany: Boring Company
longboarding: long boarding
AnimalCrossingNewHor: Animal Crossing New Hor
wimmelbilder: wimmelbilder
linuxadmin: linux admin
InnocentlyNaughty: Innocently Naughty
SpidermanPS4: Spiderman PS4
SnapchatSext: Snapchat Sext
Barelylegal: Barely legal
AfterEffects: After Effects
privacytoolsIO: privacy tools IO
androiddev: android dev
Psychedelics: Psychedelics
secretcompartments: secret compartments
antiassholedesign: anti asshole design
BadDesigns: Bad Designs
sploot: sploot
SeattleWA: Seattle WA
MCPE: MCPE
opendirectories: open directories
pussyjobs: pussy jobs
ManufacturingPorn: Manufacturing Porn
MaluTrevejoOnlyFans: Malu Trevejo Only Fans
makeupexchange: makeup exchange
desabafos: desabafos
Colorado: Colorado
SPACs: SPACs
Animalsthatlovemagic: Animals that love magic
amazon: Amazon
lawofattraction: law of attraction
puppy101: puppy 101
Keep_Track: Keep_Track
linux4noobs: linux 4 noobs
LawSchool: Law School
matureplants: mature plants
me_irlgbt: me in real life LGBT
thongs: thongs
broslikeus: bros like us
StarWarsLeaks: Star Wars Leaks
chaoticgood: chaotic good
NSFWgaming: NSFW gaming
svenskpolitik: svenskpolitik
Pikabu: Pikabu
WeightLossAdvice: Weight Loss Advice
Stellar: Stellar
PowerShell: Power Shell
GTA: GTA
ImaginaryMindscapes: Imaginary Mindscapes
homesex: home sex
trippy: trippy
Sashagrey: Sasha grey
Throatfucking: Throat fucking
Borderlands2: Borderlands 2
poker: poker
BBCparadise: BBC paradise
SuctionBlowjobs: Suction Blowjobs
beyondthebump: beyond the bump
WiggleButts: Wiggle Butts
csharp: C Sharp
BritishSuccess: British Success
MensLib: Mens Lib
socialmedia: social media
etymology: etymology
GoneWildCD: Gone Wild CD
tylerthecreator: Tyler The Creator
TheExpanse: The Expanse
winterporn: winter porn
sequence: sequence
BeansInThings: Beans In Things
MacOS: Mac OS
uberdrivers: Uber Drivers
AreolasGW: Areolas GW
agedlikewine: aged like wine
fantasybball: fantasy basketball
Infographics: Infographics
starbucks: Starbucks
shavedpussies: shaved pussies
Warzone: Warzone
TOR: TOR
MetalMemes: Metal Memes
sandiego: San Diego
physicsgifs: physics gifs
budgetcooking: budget cooking
TalesFromThePizzaGuy: Tales From The Pizza Guy
NSFWCostumes: NSFW Costumes
coltish: coltish
DemEyesDoe: Dem Eyes Doe
swtor: swtor
Bumble: Bumble
AmateurSlutsGW: Amateur Sluts GW
MMORPG: MMORPG
pitbulls: pit bulls
AsianCumsluts: Asian Cumsluts
Republican: Republican
funkopop: funkopop
WikiLeaks: WikiLeaks
tipofmyjoystick: tip of my joystick
groupsex: group sex
fishnets: fishnets
Vive: Vive
AmericanHorrorStory: American Horror Story
Fuckthealtright: Fuck the alt right
mmgirls: mm girls
mlem: mlem
EbonyCuties: Ebony Cuties
ArianaGrande: Ariana Grande
Suomi: Suomi
EntrepreneurRideAlong: Entrepreneur Ride Along
ENLIGHTENEDCENTRISM: ENLIGHTENED CENTRISM
VolleyballGirls: Volleyball Girls
HalfLife: Half Life
KimmyGranger: Kimmy Granger
ImaginaryBehemoths: Imaginary Behemoths
ThickDick: Thick Dick
programminghorror: programming horror
Re_Zero: Re Zero
PSVR: PSVR
LodedDiper: Loded Diper
ladyladyboners: lady lady boners
whatsthisbird: what's this bird
virginvschad: Virgin vs Chad
Leathercraft: Leathercraft
dyinglight: dying light
aws: AWS
portugal: Portugal
gay_irl: gay in real life
ghibli: ghibli
FeedingOnCum: Feeding On Cum
EmilyWillis: Emily Willis
NSFWBarista: NSFW Barista
gamecollecting: game collecting
FreeuseHentai: Freeuse Hentai
The_Dennis: The Dennis
TeenTitansPorn: Teen Titans Porn
Rule34Overwatch: Rule 34 Overwatch
piercednipples: pierced nipples
asktransgender: ask transgender
OnOffCelebs: On Off Celebs
100yearsago: 100 years ago
DrawMyTattoo: Draw My Tattoo
PornStars: Porn Stars
StandUpComedy: Stand Up Comedy
DirtyGaming: Dirty Gaming
WeddingRingsShowing: Wedding Rings Showing
GodofWar: God of War
AlexisTexas: Alexis Texas
WarshipPorn: Warship Porn
dontflinch: don't flinch
myfavoritemurder: my favorite murder
AnthemTheGame: Anthem The Game
Babes: Babes
Hitomi_Tanaka: Hitomi Tanaka
internetparents: internet parents
Misogynyfetish: Misogyny Fetish
vaporents: vapor rents
Illustration: Illustration
Pets: Pets
progun: pro gun
ITCareerQuestions: IT Career Questions
Kendra_Sunderland: Kendra Sunderland
travisscott: Travis Scott
darknet: dark net
lfg: lfg
classysexy: classy sexy
crypto: crypto
DivinityOriginalSin: Divinity Original Sin
collegensfw: college nsfw
before_after_cumsluts: before after cum sluts
EmilyBloom: Emily Bloom
Tgifs: Tgifs
WTFgaragesale: WTF garage sale
Witcher3: Witcher 3
SampleSize: Sample Size
RateMyAss: Rate My Ass
riddles: riddles
NorthCarolina: North Carolina
dillion_harper: Dillion Harper
DarK: DarK
EdibleButtholes: Edible Buttholes
security: security
bestofnetflix: best of Netflix
BestCamSluts: Best Cam Sluts
ForeverAloneDating: Forever Alone Dating
thebachelor: the bachelor
TaylorSwift: Taylor Swift
moviescirclejerk: movies circle jerk
PornoMemes: Porno Memes
2b2t: 2b2t
Stepdadreflexes: Stepdad reflexes
howyoudoin: how you doin
SEO: SEO
Firearms: Firearms
ImaginaryWesteros: Imaginary Westeros
doggy: doggy
chile: chile
family: family
CumFromAnal: Cum From Anal
StarVStheForcesofEvil: Star VS the Forces of Evil
kendalljenner: kendalljenner
BlackClover: Black Clover
CelebrityNipples: Celebrity Nipples
HentaiParadise: Hentai Paradise
ios: iOS
fuckmeat: fuckmeat
jesuschristouija: jesuschristouija
megnuttleaks: megnuttleaks
norge: norge
MilitaryGfys: Military Gfys
fashionporn: fashion porn
mombod: mombod
Permaculture: Permaculture
HoleWreckers: Hole Wreckers
AmandaCerny: Amanda Cerny
gaybrosgonemild: gaybros gone mild
DankLeft: Dank Left
LittleCaprice: Little Caprice
sexover30: sex over 30
SecurityAnalysis: Security Analysis
redditrequest: reddit request
CrimeScene: Crime Scene
UpvotedBecauseButt: Upvoted Because Butt
bodyshots: body shots
SexWorkers: Sex Workers
RedheadGifs: Redhead Gifs
fatFIRE: fat FIRE
Paleo: Paleo
onguardforthee: onguardforthee
suddenlysexoffender: suddenlysexoffender
DeathStranding: Death Stranding
reverseanimalrescue: reverse animal rescue
PokemonGoSpoofing: Pokemon Go Spoofing
TheOnion: The Onion
survivinginfidelity: surviving infidelity
MILFs: MILFs
love: love
cfnm: cfnm
naturalbodybuilding: natural bodybuilding
JonTron: Jon Tron
learnjavascript: learn javascript
2020PoliceBrutality: 2020 Police Brutality
PetiteNSFW: Petite NSFW
bearsdoinghumanthings: bears doing human things
flying: flying
CatsWithDogs: Cats With Dogs
PublicBoys: Public Boys
tolkienfans: tolkien fans
eFreebies: e Freebies
EatCheapAndVegan: Eat Cheap And Vegan
phgonewild: ph gone wild
CumHentai: Cum Hentai
RDR2: RDR2
RandomKindness: Random Kindness
The_Mueller: The Mueller
murdermittens: murder mittens
Adorable_Girls: Adorable Girls
spiderbro: spider bro
AsianAmericanPorn: Asian American Porn
fnv: fnv
Busty_Girls: Busty Girls
razer: razer
Spanish: Spanish
GiannaMichaels: Gianna Michaels
anriokita: anriokita
whiteknighting: white knighting
rockets: rockets
AhegaoGirls: Ahegao Girls
The10thDentist: The 10th Dentist
washingtondc: washington dc
hentai_irl: hentai irl
Scotland: Scotland
redditmobile: reddit mobile
alexandradaddario: alexandradaddario
sffpc: sff pc
JuliaRose: Julia Rose
MushroomGrowers: Mushroom Growers
cowboys: cowboys
sololeveling: solo leveling
nicoleaniston: nicoleaniston
GalGadot: Gal Gadot
lockpicking: lock picking
EmilyRatajkowski: Emily Ratajkowski
tight_shorts: tight shorts
Multitaskers: Multitaskers
androidthemes: android themes
Random_Acts_Of_Amazon: Random Acts Of Amazon
donaldglover: donald glover
LWIAY: LWIAY
Ghoststories: Ghost stories
BeginnerWoodWorking: Beginner Wood Working
girlsmasturbating: girls masturbating
YoungGirlsGoneWild: Young Girls Gone Wild
WatchRedditDie: Watch Reddit Die
FromBelowView: From Below View
law: law
AwesomeOffBrands: Awesome Off Brands
APStudents: AP Students
analinsertions: anal insertions
AmateurDeepthroat: Amateur Deepthroat
proplifting: prop lifting
plants: plants
fifthworldproblems: fifth world problems
BustyNaturals: Busty Naturals
AOC: AOC
videography: videography
youtubers: youtubers
KneadyCats: Kneady Cats
DirtyConfession: Dirty Confession
AnimalPorn: Animal Porn
NSFWGirl: NSFW Girl
GameOfThronesMemes: Game Of Thrones Memes
Floof: Floof
FlashTV: Flash TV
Eve: Eve
CumshotSelfies: Cumshot Selfies
Calligraphy: Calligraphy
battlemaps: battle maps
SexyWomanOfTheDay: Sexy Woman Of The Day
PhotoshopTutorials: Photoshop Tutorials
reddeadmysteries: red dead mysteries
chicagobulls: chicago bulls
ilikthebred: ilikthebred
dragonballfighterz: dragon ball fighterz
MegNutt: Meg Nutt
Pee: Pee
GaySnapchat: Gay Snapchat
survivor: survivor
ForeverAlone: Forever Alone
punk: punk
malaysia: malaysia
barstoolsports: barstool sports
BlowjobEyeContact: Blowjob Eye Contact
OurPresident: Our President
sciencefiction: science fiction
HighMileageHoles: High Mileage Holes
shitpost: shitpost
AdPorn: Ad Porn
BBW_Chubby: BBW Chubby
supremeclothing: supreme clothing
AirForce: Air Force
DrunkGirls: Drunk Girls
russia: russia
waifusgonewild: waifus gone wild
GolemSexy: Golem Sexy
recruitinghell: recruiting hell
redditsings: reddit sings
LinusTechTips: Linus Tech Tips
IndiaSpeaks: India Speaks
goldenretrievers: golden retrievers
Mirrorsforsale: Mirrors for sale
MyCherryCrush: My Cherry Crush
wholesomeyuri: wholesome yuri
justdependathings: just dependa things
Eminem: Eminem
dankruto: dankruto
90dayfianceuncensored: 90 Day Fiance Uncensored
Hue: Hue
lolgrindr: lol grindr
Onlyfans_Promo: Onlyfans Promo
CasualJiggles: Casual Jiggles
JavDownloadCenter: Jav Download Center
trans: trans
BollywoodRealism: Bollywood Realism
KimetsuNoYaiba: Kimetsu No Yaiba
microdosing: microdosing
BreadTube: Bread Tube
indiangirls: indian girls
nosurf: nosurf
brasilivre: brasilivre
yiffinhell: yiff in hell
Kikpals: Kik pals
LegendsOfRuneterra: Legends Of Runeterra
DivorcedBirds: Divorced Birds
QAnonCasualties: QAnon Casualties
skeptic: skeptic
BestOfReports: Best Of Reports
ecommerce: e-commerce
omad: omad
cowboybebop: cowboy bebop
leahgotti: leahgotti
RedditorCum: Redditor Cum
OnlyFansStars: OnlyFans Stars
mila_azul: mila_azul
Showersex: Shower sex
ClimbingPorn: Climbing Porn
MDMA: MDMA
wine: wine
gamedesign: game design
AnalOrgasms: Anal Orgasms
consulting: consulting
NekoIRL: Neko IRL
goodyearwelt: goodyear welt
funnysigns: funny signs
birding: birding
crossdressing: crossdressing
BDSMpersonals: BDSM personals
FemaleDatingStrategy: Female Dating Strategy
TightShorts: Tight Shorts
Dashcam: Dashcam
GirlsInFlarePants: Girls In Flare Pants
ImaginaryCityscapes: Imaginary Cityscapes
TVDetails: TV Details
CheatingSluts: Cheating Sluts
panties: panties
cuckoldcaptions: cuckold captions
fatpeoplehate: fatpeoplehate
RWBY: RWBY
catpics: cat pics
javdreams: jav dreams
kurzgesagt: kurzgesagt
BackYardChickens: Backyard Chickens
lewdgames: lewd games
RandomActsOfGaming: Random Acts Of Gaming
Jia_Lissa: Jia Lissa
Mcat: Mcat
brisbane: brisbane
YoungPrettyHoes: Young Pretty Hoes
sneakermarket: sneaker market
GonewildGBUK: Gonewild GBUK
NSFWfashion: NSFW fashion
MacroPorn: Macro Porn
islam: islam
facingtheirparenting: facing their parenting
HomeworkHelp: Homework Help
KateeOwen: Katee Owen
squirting_gifs: squirting gifs
gilf: gilf
BonerAlert: Boner Alert
torrents: torrents
Bisexy: Bisexy
rugbyunion: rugby union
handjobs: handjobs
KylieJenner: Kylie Jenner
Mommy_tits: Mommy tits
dragonage: dragon age
BreakUps: Break Ups
dontstarve: don't starve
titlegore: title gore
Amish: Amish
TheHangingBoobs: The Hanging Boobs
WorkIt: Work It
Annoyedtobenude: Annoyed to be nude
FreezingFuckingCold: Freezing Fucking Cold
ShitRedditSays: Shit Reddit Says
darkestdungeon: darkest dungeon
whereintheworld: where in the world
weddingplanning: wedding planning
hentaifemdom: hentai femdom
MagicEye: Magic Eye
SunDressesGoneWild: Sun Dresses Gone Wild
vagina: vagina
IWantToBeHerHentai: I Want To Be Her Hentai
minnesota: minnesota
JUSTNOFAMILY: JUSTNOFAMILY
JojosBizarreMemePage: Jojo's Bizarre Meme Page
kittens: kittens
bois: bois
steak: steak
nsfwasmr: nsfw asmr
Break_Yo_Dick_Thick: Break Yo Dick Thick
Whatisthis: What is this
Youtooz: Youtooz
ClothedTitfuck: Clothed Titfuck
wwiipics: WWII pics
ainbow: a in bow
penpals: pen pals
Crunchyroll: Crunchyroll
BadMensAnatomy: Bad Men's Anatomy
overlord: overlord
MadeMeCry: Made Me Cry
EDH: EDH
Switch: Switch
Hunting: Hunting
randonauts: randonauts
TheFappening: The Fappening
disneyporn: disney porn
sales: sales
Alternativerock: Alternative rock
insertions: insertions
steelers: steelers
masterhacker: master hacker
eroticliterature: erotic literature
SaimanSays: Saiman Says
CanadaPolitics: Canada Politics
MGTOW: MGTOW
discgolf: disc golf
gape: gape
fatestaynight: fate stay night
Slutsofonlyfans: Sluts of only fans
enf: enf
BrandiLove: Brandi Love
uselessredcircle: useless red circle
snapchatgw: snapchatgw
Death_By_SnuSnu: Death By SnuSnu
wholesome: wholesome
PutAnEggOnIt: Put An Egg On It
janicegriffith: janice griffith
BigBrother: Big Brother
Xiaomi: Xiaomi
TurkeyJerky: Turkey Jerky
toddlers: toddlers
DeepFuckingValue: Deep Fucking Value
SkincareAddictionUK: Skincare Addiction UK
naughtychicks: naughty chicks
DragonballLegends: Dragonball Legends
sciences: sciences
muglife: mug life
farcry: far cry
WrestleWithThePlot: Wrestle With The Plot
LGBTeens: LGBT Teens
Watchexchange: Watch Exchange
AppHookup: App Hookup
Megumin: Megumin
comicbookmovies: comic book movies
AskNetsec: Ask Netsec
KendrickLamar: Kendrick Lamar
belgium: belgium
HugeDildos: Huge Dildos
Natureisbrutal: Nature is brutal
FutanariPegging: Futanari Pegging
golang: go lang
KelsiMonroe: Kelsi Monroe
BehindTheSceneNSFW: Behind The Scene NSFW
learntodraw: learn to draw
PunkGirls: Punk Girls
AnimeBooty: Anime Booty
SexiestPetites: Sexiest Petites
CoDCompetitive: CoD Competitive
homeowners: homeowners
B_Cups: B Cups
horizon: horizon
1500isplenty: 1500 is plenty
EmmaWatson: Emma Watson
swordartonline: sword art online
pagan: pagan
bujo: bujo
fictionalpsychology: fictional psychology
uncommonposes: uncommon poses
evenwithcontext: even with context
RATS: RATS
SWARJE: SWARJE
DemocraticSocialism: Democratic Socialism
CatsISUOTTATFO: Cats ISUOTTATFO
fuckHOA: fuck HOA
catfaceplant: cat face plant
BoobsBetweenArms: Boobs Between Arms
SFMCompileClub: SFM Compile Club
namenerds: name nerds
AirBnB: AirBnB
Scotch: Scotch
CorporateFacepalm: Corporate Facepalm
ButtSharpies: Butt Sharpies
samespecies: same species
gaynsfw: gay NSFW
GameOverGirls: Game Over Girls
HaveWeMet: Have We Met
jellybeantoes: jelly bean toes
MiniLadd: Mini Ladd
BelleDelphineXmas: Belle Delphine Xmas
GirlsinSchoolUniforms: Girls in School Uniforms
Ohio: Ohio
COMPLETEANARCHY: COMPLETE ANARCHY
GloryHo: Glory Ho
pantsu: pantsu
ghostoftsushima: ghost of tsushima
trackers: trackers
electricians: electricians
Demotivational: Demotivational
tiltshift: tilt shift
showerbeer: shower beer
1000ccplus: 1000 cc plus
Mexicana: Mexicana
catbellies: cat bellies
starwarsspeculation: star wars speculation
introverts: introverts
dividends: dividends
FreeCompliments: Free Compliments
chloe: chloe
FuckableSplits: Fuckable Splits
darkmemes: dark memes
TalesFromThePharmacy: Tales From The Pharmacy
slammywhammies: slammy whammies
highheelsNSFW: high heels NSFW
Dachshund: Dachshund
femboy: femboy
Anarcho_Capitalism: Anarcho Capitalism
furry_irl: furry irl
billieeilish: billie eilish
MeanJokes: Mean Jokes
pic: pic
BelleDelphineLewds: Belle Delphine Lewds
womenofcolorXXX: women of color XXX
Choker: Choker
konmari: konmari
AlisonBrie: Alison Brie
robotics: robotics
Sourdough: Sourdough
Bulges: Bulges
HomemadeNsfw: Homemade Nsfw
nude_snapchat: nude snapchat
PourPainting: Pour Painting
Hacking_Tutorials: Hacking Tutorials
DestinyFashion: Destiny Fashion
amex: amex
LesbianActually: Lesbian Actually
iosgaming: ios gaming
FoundPaper: Found Paper
legostarwars: lego star wars
EyeRollOrgasm: Eye Roll Orgasm
PUBLICNUDITY: PUBLIC NUDITY
oilpainting: oil painting
Repaintings: Repaintings
MilitaryGoneWild: Military Gone Wild
StonerPhilosophy: Stoner Philosophy
passive_income: passive income
UmbrellaAcademy: Umbrella Academy
ImpresssedByCum: Impresssed By Cum
GirlGamers: Girl Gamers
hackintosh: hackintosh
ChavGirls: Chav Girls
FreckledGirls: Freckled Girls
Anal_witch: Anal witch
SpeedOfLobsters: Speed Of Lobsters
guitarpedals: guitar pedals
xkcd: xkcd
wifeshare: wife share
postprocessing: post processing
brunette: brunette
drunkencookery: drunken cookery
prematurecumshots: premature cumshots
Surface: Surface
redditmoment: reddit moment
printSF: print SF
musicproduction: music production
InstagramHotties: Instagram Hotties
CoronavirusUS: Coronavirus US
ROBLOXmemes: ROBLOX memes
michaelbaygifs: michael bay gifs
BudgetAudiophile: Budget Audiophile
easytofuck: easytofuck
datasets: data sets
49ers: 49ers
Gunpla: Gunpla
Avengers: Avengers
cannabis: cannabis
TrueCrimePodcasts: True Crime Podcasts
DestinyLore: Destiny Lore
ThinkTankSexy: Think Tank Sexy
foxes: foxes
happygirls: happy girls
victoriajustice: victoria justice
195: 195
doodles: doodles
NewSkaters: New Skaters
casualChildAbuse: casual Child Abuse
Presenting: Presenting
FuckingPerfect: Fucking Perfect
ShittyAnimalFacts: Shitty Animal Facts
shield: shield
Ahegao_IRL: Ahegao IRL
CrewsCrew: Crews Crew
dankvideos: dank videos
straponlesbians: strap on lesbians
AbusePorn2: Abuse Porn 2
fatpeoplestories: fat people stories
artificial: artificial
ottawa: ottawa
TILI: TILI
Genshin_Memepact: Genshin Memepact
gag_spit: gag spit
scissoring: scissoring
ImaginaryArchitecture: Imaginary Architecture
sophiedee: sophiedee
InterdimensionalCable: Interdimensional Cable
SocialEngineering: Social Engineering
Monitors: Monitors
opensource: open source
GamingLeaksAndRumours: Gaming Leaks And Rumours
knifeclub: knife club
loadingicon: loading icon
ExtremeCarCrashes: Extreme Car Crashes
grandpajoehate: grandpa joe hate
JustUnsubbed: Just Unsubbed
veganfitness: vegan fitness
ThatPeelingFeeling: That Peeling Feeling
audiobooks: audio books
cunnilingus: cunnilingus
Stormlight_Archive: Stormlight Archive
onetruegod: one true god
MakeMyCoffin: Make My Coffin
notdisneyvacation: not disney vacation
falloutlore: fallout lore
fuckthesepeople: fuck these people
ParlerWatch: Parler Watch
PetiteGirls: Petite Girls
StuffOnCats: Stuff On Cats
FamosasGostosas: Famosas Gostosas
Heavymind: Heavy mind
Frugal_Jerk: Frugal Jerk
deliciouscompliance: delicious compliance
sexy_angels: sexy angels
drums: drums
unexpectedoffice: unexpected office
EbonyGirls: Ebony Girls
Trumpgret: Trumpgret
liluzivert: liluzivert
iWallpaper: i Wallpaper
hotfallingdevilz: hot falling devilz
FriendsGoneWild: Friends Gone Wild
AzureLane: Azure Lane
PHP: PHP
Offensivejokes: Offensive jokes
FullPornSources: Full Porn Sources
legaladviceofftopic: legal advice off topic
wifeporn: wife porn
Amouranth: Amouranth
AshleyAlban: Ashley Alban
Madden: Madden
ConanExiles: Conan Exiles
ShitLiberalsSay: Shit Liberals Say
EmKay: Em Kay
GloryholeBlowjobs: Gloryhole Blowjobs
RWBYNSFW: RWBY NSFW
PERSoNA: PERSoNA
DrunkOrAKid: Drunk Or A Kid
BillieEilishGW: Billie Eilish GW
theouterworlds: the outer worlds
untrustworthypoptarts: untrustworthy poptarts
liberalgunowners: liberal gun owners
Mavericks: Mavericks
Hentai4Everyone: Hentai 4 Everyone
dangerousdesign: dangerous design
Pennsylvania: Pennsylvania
French: French
rap: rap
legsup: legs up
asaakira: asaakira
AITA: AITA
newreddits: new reddits
flightsim: flight sim
PAWGtastic: PAWGtastic
rust: rust
Sissyperfection: Sissy perfection
highdeas: high ideas
KarmaConspiracy: Karma Conspiracy
Objects: Objects
PresidentialRaceMemes: Presidential Race Memes
Wordpress: WordPress
oilpen: oil pen
equelMemes: equel Memes
NewProductPorn: New Product Porn
ChapoTrapHouse: Chapo Trap House
TheUnderbun: The Underbun
FanFiction: Fan Fiction
Youniqueamua: Younique amua
NotKenM: Not Ken M
funnyvideos: funny videos
DemiRoseMawby: Demi Rose Mawby
infp: infp
twentyonepilots: twenty one pilots
SheMakesHerSuck: She Makes Her Suck
PetTheDamnCat: Pet The Damn Cat
Technoblade: Technoblade
Vaping: Vaping
BigCatGifs: Big Cat Gifs
gaymersgonewild: gaymers gone wild
GetEmployed: Get Employed
catpictures: cat pictures
stephenking: Stephen King
SatisfactoryGame: Satisfactory Game
ToolBand: Tool Band
slightcellulite: slight cellulite
IsTodayFridayThe13th: Is Today Friday The 13th
DadsGoneWild: Dads Gone Wild
discord_irl: discord irl
SnapLenses: Snap Lenses
WeirdWheels: Weird Wheels
leafs: leafs
spongebob: spongebob
yaoi: yaoi
myheroacademiahentai: my hero academia hentai
iOSBeta: iOS Beta
TeensNSFW: Teens NSFW
firefox: firefox
ThotX: Thot X
ScarlettJohansson: Scarlett Johansson
IDOWORKHERELADY: IDO WORK HERE LADY
WordAvalanches: Word Avalanches
BestTits: Best Tits
bettafish: betta fish
PussyWedgie: Pussy Wedgie
montageparodies: montage parodies
communism101: communism 101
LowSodiumCyberpunk: Low Sodium Cyberpunk
femdomgonewild: femdom gone wild
Kaguya_sama: Kaguya sama
Frontend: Frontend
CosplayPornVideos: Cosplay Porn Videos
gamingsuggestions: gaming suggestions
fastfood: fast food
bigtitsmallnip: big tits small nip
software: software
JDM: JDM
LisaAnn: Lisa Ann
sporetraders: spore traders
KingOfTheHill: King Of The Hill
trap: trap
tightsqueeze: tight squeeze
Onlyfanspromoss: Onlyfans promoss
assholetax: asshole tax
beatles: beatles
Delightfullychubby: Delightfully chubby
GirlsWithGirls: Girls With Girls
5050pics: 50/50 pics
AyyMD: Ayy MD
ArabPorn: Arab Porn
bipolar: bipolar
AllAboutBoobs: All About Boobs
Blacksmith: Blacksmith
Im15AndThisIsYeet: Im 15 And This Is Yeet
montreal: montreal
mlb: MLB
Hugeboobshardcore: Huge boobs hardcore
mycleavage: my cleavage
JRPG: JRPG
gachagaming: gacha gaming
ThickAsians: Thick Asians
forcedbreeding: forced breeding
BlackGirlBlowjobs: Black Girl Blowjobs
wet: wet
battlefield_4: battlefield 4
cum: cum
StreetFighter: Street Fighter
FifaCareers: Fifa Careers
brockhampton: brockhampton
SluttyHalloween: Slutty Halloween
adhdmeme: adhd meme
SoundsLikeMusic: Sounds Like Music
milfcumsluts: milf cum sluts
dreamsmp: dreamsmp
HeadphoneAdvice: Headphone Advice
orangetheory: orange theory
milkingtable: milking table
Seahawks: Seahawks
overlanding: overlanding
mildlysatisfying: mildly satisfying
celebJObuds: celeb JO buds
CGPGrey: CGP Grey
MeganRain: Megan Rain
Metalcore: Metalcore
thebutton: the button
ShinyPokemon: Shiny Pokemon
redditsync: reddit sync
Political_Revolution: Political Revolution
DarlingInTheFranxx: Darling In The Franxx
consentacles: consentacles
Sherlock: Sherlock
toosoon: too soon
FairytaleasFuck: Fairytale as Fuck
CICO: CICO
kindle: kindle
tonightsdinner: tonight's dinner
AthleticGirls: Athletic Girls
XXXTENTACION: XXXTENTACION
casualnudity: casual nudity
ExhibitionistSex: Exhibitionist Sex
Fisting: Fisting
lucifer: lucifer
vim: vim
snakes: snakes
PillowHumping: Pillow Humping
NSFW_China: NSFW China
docker: docker
HentaiSource: Hentai Source
3d6: 3d6
Saggy: Saggy
RepLadies: Rep Ladies
Yogscast: Yogscast
Alisai: Alisai
Bottomless: Bottomless
foraging: foraging
sweatermeat: sweater meat
BPD: BPD
AvatarPorn: Avatar Porn
microsoft: Microsoft
GoNets: Go Nets
EbonyThroatQueens: Ebony Throat Queens
Weird: Weird
ik_ihe: ik ihe
GhanaSaysGoodbye: Ghana Says Goodbye
uncensorednews: uncensored news
education: education
nbadiscussion: NBA discussion
ModelsGoneMild: Models Gone Mild
NieceWaidhofer: Niece Waidhofer
Iota: Iota
japanpornstars: japan porn stars
Handjob: Handjob
DigitalArt: Digital Art
firefly: firefly
gaystoriesgonewild: gay stories gone wild
creampiegangbangs: creampie gangbangs
MeetPeople: Meet People
poland: Poland
transtimelines: trans timelines
BitLifeApp: BitLife App
GODZILLA: GODZILLA
wasletztepreis: was letzte preis
CompetitiveWoW: Competitive WoW
minnesotavikings: minnesota vikings
40kLore: 40k Lore
Phatasswhitegirls: Phat ass white girls
advertising: advertising
fragrance: fragrance
LilGrabbies: Lil Grabbies
CreepyWikipedia: Creepy Wikipedia
araragi: araragi
Drama: Drama
cumontongue: cum on tongue
OnlyHoes: Only Hoes
CHIBears: CHI Bears
Lost_Architecture: Lost Architecture
bingbongtheorem: bing bong theorem
exxxchange: exxx change
MkeBucks: Mke Bucks
iphonewallpapers: iPhone wallpapers
RetroPie: Retro Pie
amcstock: amc stock
underboob: underboob
badcode: bad code
fuckingmachines: fucking machines
smilers: smilers
C25K: C25K
Brawlhalla: Brawlhalla
TopSecretRecipes: Top Secret Recipes
DessertPorn: Dessert Porn
Zerkaa: Zerkaa
GushingGirls: Gushing Girls
arknights: arknights
intresseklubben: intresseklubben
UnexpectedJoJo: Unexpected JoJo
beerporn: beer porn
SympatheticMonsters: Sympathetic Monsters
bizarrebuildings: bizarre buildings
BravoRealHousewives: Bravo Real Housewives
BanVideoGames: Ban Video Games
wildlifephotography: wildlife photography
ntbdbiwdfta: ntbdbiwdfta
LoveToWatchYouLeave: Love To Watch You Leave
chairsunderwater: chairs underwater
GenshinImpactNSFW: Genshin Impact NSFW
esist: esist
GillianBarnes: Gillian Barnes
russian: russian
Vechain: Vechain
SoGoodtoBeBad: So Good To Be Bad
FullShrimp: Full Shrimp
2Booty: 2 Booty
HardcoreNSFW: Hardcore NSFW
EnterTheGungeon: Enter The Gungeon
gopro: gopro
animepiracy: anime piracy
WhatIsThisPainting: What Is This Painting
VerifiedFeet: Verified Feet
fixit: fixit
oneliners: one liners
woweconomy: wow economy
tax: tax
bleach: bleach
obs: obs
florida: florida
IncestComics: Incest Comics
UnexpectedlyWholesome: Unexpectedly Wholesome
phoenix: phoenix
sissypersonals: sissy personals
mangonewild: mango new wild
Tiresaretheenemy: Tires are the enemy
Jeep: Jeep
AnarchyChess: Anarchy Chess
nudefrog: nude frog
KotakuInAction: Kotaku In Action
LilyKawaii: Lily Kawaii
MissAlice_18: Miss Alice 18
CCW: CCW
DumpsterDiving: Dumpster Diving
Awww: Awww
sissycaptions: sissy captions
HijabiXXX: Hijabi XXX
jacking: jacking
NYKnicks: NY Knicks
ForwardsFromKlandma: Forwards From Klandma
Etsy: Etsy
Costco: Costco
Boruto: Boruto
bookporn: book porn
RepTime: Rep Time
FalloutMods: Fallout Mods
digital_marketing: digital marketing
transgender: transgender
ak47: ak47
NMSCoordinateExchange: NMS Coordinate Exchange
DesiBoners: Desi Boners
bangalore: bangalore
rpg_gamers: rpg gamers
walmart: walmart
SaraJUnderwood: Sara J Underwood
TrashTaste: Trash Taste
googleplaydeals: google play deals
repurposedbuildings: repurposed buildings
tscumsluts: tscumsluts
twinpeaks: twin peaks
Oxygennotincluded: Oxygen not included
dubstep: dubstep
femalelivingspace: female living space
MemePiece: Meme Piece
OrganicGardening: Organic Gardening
PussyFlashing: Pussy Flashing
teslore: tes lore
vexillologycirclejerk: vexillology circle jerk
fantasybaseball: fantasy baseball
ComplexionExcellence: Complexion Excellence
Lordosis: Lordosis
selfhelp: self help
botw: botw
shorthairedhotties: short haired hotties
Scrubs: Scrubs
southafrica: south africa
castles: castles
btd6: btd6
gifextra: gif extra
OnlyFansAsstastic: OnlyFans Asstastic
streeteats: street eats
tall: tall
PerfectPussies: Perfect Pussies
energy_work: energy work
AlternateAngles: Alternate Angles
CatsOnKeyboards: Cats On Keyboards
trailrunning: trail running
INTP: INTP
Feet_NSFW: Feet NSFW
Humongousaurustits: Humongousaurus tits
ballsdeepandcumming: balls deep and cumming
Rule34RainbowSix: Rule 34 Rainbow Six
NadyaNabakova: Nadya Nabakova
iNoobChannel: iNoob Channel
WatchDogsWoofInside: Watch Dogs Woof Inside
peegonewild: pee gone wild
KimKardashianPics: Kim Kardashian Pics
CBD: CBD
hentaicaptions: hentai captions
Tekken: Tekken
Amateurincest: Amateur incest
iOSthemes: iOS themes
MusicForConcentration: Music For Concentration
SexToys: Sex Toys
Whoregasm: Whoregasm
NFA: NFA
HomemadeGayPorn: Homemade Gay Porn
PlayItAgainSam: Play It Again Sam
videogamedunkey: video game dunkey
foreskin: foreskin
Idiotswithguns: Idiots with guns
learnspanish: learn spanish
amazonposition: amazon position
tf2shitposterclub: tf2 shitposter club
CumKiss: Cum Kiss
JuJutsuKaisen: Ju Jutsu Kaisen
replications: replications
Naturalhair: Natural hair
stopsmoking: stop smoking
TokyoGhoul: Tokyo Ghoul
friendsafari: friend safari
productgif: product gif
flashlight: flashlight
WhatsInThisThing: What's In This Thing
RaeLilBlack: Rae Lil Black
libertarianmeme: libertarian meme
BlackPink: Black Pink
Spanking: Spanking
NotTimAndEric: Not Tim And Eric
nier: nier
oblivion: oblivion
sneakyporn: sneaky porn
ButterflyWings: Butterfly Wings
dfsports: dfsports
shittykickstarters: shitty kickstarters
MicroPorn: Micro Porn
sustainability: sustainability
TheCatTrapIsWorking: The Cat Trap Is Working
KendraLust: Kendra Lust
ender3: ender3
NameThatSong: Name That Song
DuelLinks: Duel Links
superheroporn: superhero porn
Facials: Facials
MAAU: MAAU
pinkfloyd: pink floyd
AFL: AFL
PremiumSnapchat: Premium Snapchat
Hairy: Hairy
Random_Acts_Of_Pizza: Random Acts Of Pizza
Bioshock: Bioshock
VeganFoodPorn: Vegan Food Porn
LudwigAhgren: Ludwig Ahgren
JadaStevens: Jada Stevens
unexpectedjihad: unexpected jihad
UnexpectedMulaney: Unexpected Mulaney
weeabootales: weeaboo tales
bigboobs: big boobs
NPR: NPR
ShokugekiNoSoma: Shokugeki No Soma
jerkofftomymom: jerk off to my mom
GiftofGames: Gift of Games
Hiphopcirclejerk: Hip Hop Circlejerk
GirlsWithToys: Girls With Toys
shopify: shopify
deathgrips: death grips
valentinanappi: valentina nappi
shittydarksouls: shitty dark souls
duolingo: duolingo
oldfreefolk: old freefolk
ForzaHorizon: Forza Horizon
tacticalgear: tactical gear
facts: facts
homeassistant: home assistant
PeakyBlinders: Peaky Blinders
Roms: Roms
CatGifs: Cat Gifs
CelebrityCandids: Celebrity Candids
opiates: opiates
selfhosted: self hosted
orangecounty: orange county
sexystories: sexy stories
carbage: carbage
SpotifyPlaylists: Spotify Playlists
edging: edging
alteredbuttholes: altered buttholes
IndianPorn: Indian Porn
BisexualFantasy: Bisexual Fantasy
Dinosaurs: Dinosaurs
cuteasfuckbutclothed: cute as fuck but clothed
CamGirls: Cam Girls
letsplay: let's play
CapitolConsequences: Capitol Consequences
ynab: ynab
ToplessInJeans: Topless In Jeans
UsernameChecksOut: Username Checks Out
SquarePosting: Square Posting
CougarsAndCubs: Cougars And Cubs
thinkpad: thinkpad
masterforgiveme: master for give me
Cuties4U: Cuties 4 U
bootyshorts: booty shorts
ForgotToPullOut: Forgot To Pull Out
Phonejobs: Phone jobs
AskVet: Ask Vet
VanLife: Van Life
BBWGW: BBW GW
ape: ape
PiperPerri: Piper Perri
GuysFromBehind: Guys From Behind
SiliconValleyHBO: Silicon Valley HBO
CedehsHentai: Cedehs Hentai
uglyduckling: ugly duckling
eyeblech: eye blech
GFTJCreampie: GFTJ Creampie
bigclit: big clit
heteroflexible: heteroflexible
amazonecho: amazon echo
baberotica: babe erotica
ImaginaryHorrors: Imaginary Horrors
BigBootyGoTHICCgf: Big Booty GoTHICC gf
MxRMods: MxR Mods
aSongOfMemesAndRage: a Song Of Memes And Rage
longrange: long range
ListOfSubreddits: List Of Subreddits
neoliberal: neoliberal
MLA_Official: MLA Official
whatcarshouldIbuy: what car should I buy
cigars: cigars
khajiithaswares: khajiithas wares
TheLostWoods: The Lost Woods
TreesSuckingOnThings: Trees Sucking On Things
ClashOfClansRecruit: Clash Of Clans Recruit
Gameboy: Gameboy
BirdsBeingDicks: Birds Being Dicks
slavs_squatting: slavs squatting
PS3: PS3
arma: arma
unrealengine: unreal engine
macbookpro: macbook pro
OnlyfansPacks: Onlyfans Packs
Edmonton: Edmonton
TallGoneWild: Tall Gone Wild
SavageGarden: Savage Garden
ripcity: ripcity
nipslips: nip slips
fermentation: fermentation
hangers: hangers
LilyIvy: Lily Ivy
Catholicism: Catholicism
Keto_Food: Keto Food
CentaurGirls: Centaur Girls
SoHotItHurts: So Hot It Hurts
HistoryAnimemes: History Animemes
BokuNoMetaAcademia: Boku No Meta Academia
LickitySlit: Lickity Slit
KansasCityChiefs: Kansas City Chiefs
spaceengineers: space engineers
DrugNerds: Drug Nerds
kinksters_gone_wild: kinksters gone wild
BeautyDiagrams: Beauty Diagrams
reddeadfashion: red dead fashion
WhiteAndThick: White And Thick
dankgentina: dank gentina
urbanplanning: urban planning
AgainstHateSubreddits: Against Hate Subreddits
arizona: arizona
AmateurWifes: Amateur Wifes
deadmalls: dead malls
falcons: falcons
urbandesign: urban design
pihole: pi hole
JemWolfie: Jem Wolfie
AskAnthropology: Ask Anthropology
TikTokHot: TikTok Hot
EpicSeven: Epic Seven
whatsthatbook: what's that book
FaceofPain: Face of Pain
Thunder: Thunder
spop: spop
dropship: dropship
YAlit: YA lit
FortniteBattleRoyale: Fortnite Battle Royale
DnDHomebrew: DnD Homebrew
cleanjokes: clean jokes
bimbofication: bimbofication
Eldenring: Eldenring
bookclub: book club
lightskinbeauties: light skin beauties
TerminallyStupid: Terminally Stupid
geology: geology
BlackGirlNSFW: Black Girl NSFW
MonsterFacials: Monster Facials
warcraftlore: warcraft lore
CedehsGifs: Cedehs Gifs
AdvancedRunning: Advanced Running
alberta: alberta
TigerKing: Tiger King
Page3Glamour: Page 3 Glamour
parrots: parrots
karleegrey: karleegrey
watchthingsfly: watch things fly
Freefood: Free food
dickgirls: dick girls
muacirclejerk: mua circle jerk
outriders: outriders
STPeach: ST Peach
Destiny: Destiny
MackzjonesOF: Mackzjones OF
teachersgonewild: teachers gone wild
WhatShouldICook: What Should I Cook
RoleReversal: Role Reversal
HybridAnimals: Hybrid Animals
HardcoreNature: Hardcore Nature
asexuality: asexuality
spotted: spotted
AlternativeHistory: Alternative History
FatPussyLovers: Fat Pussy Lovers
brutalism: brutalism
puppies: puppies
nature: nature
cumtributes: cum tributes
starbound: starbound
RachelCook: Rachel Cook
dwarffortress: dwarf fortress
zerocarb: zero carb
1819club: 1819 club
dauntless: dauntless
amihot: am I hot
futurebeats: future beats
RedditsMuseumofFilth: Reddit's Museum of Filth
berlin: berlin
ArtOfRolling: Art Of Rolling
Rapekink: Rape kink
ICanDrawThat: I Can Draw That
BigBlackBootyGIFS: Big Black Booty GIFS
OCD: OCD
HipHopImages: Hip Hop Images
Urfavbaddiies: Ur fav baddies
FallenOrder: Fallen Order
InsightfulQuestions: Insightful Questions
GoneMildPlus: Gone Mild Plus
blondegirlsfucking: blonde girls fucking
beef_flaps: beef flaps
MandyMuse: Mandy Muse
FitGirlsFucking: Fit Girls Fucking
kateupton: Kate Upton
DetailCraft: Detail Craft
ambien: ambien
SuggestALaptop: Suggest A Laptop
Addons4Kodi: Addons for Kodi
SkinnyWithAbs: Skinny With Abs
YAYamateurs: YAY amateurs
bingingwithbabish: binging with babish
muchihentai: muchi hentai
Arigam3plays: Arigam3 plays
AddisonRae: Addison Rae
RedLetterMedia: Red Letter Media
mathmemes: math memes
GayGifs: Gay GIFS
n64: n64
fantanoforever: fantano forever
bowsette: bowsette
SkirtRiding: Skirt Riding
drones: drones
WebGames: Web Games
caughtandcontinued: caught and continued
EGirls: E Girls
graphicnovels: graphic novels
LadyCocks: Lady Cocks
DoggywithHairPulling: Doggy with Hair Pulling
kingdomcome: kingdom come
gwent: gwent
JapaneseGameShows: Japanese Game Shows
vmware: vmware
Crystals: Crystals
shaidenrogue: shaiden rogue
navy: navy
lesbianOral: lesbian Oral
Paintings: Paintings
lolcats: lol cats
arrow: arrow
photographs: photographs
WWII: WWII
BrokenBabes: Broken Babes
AtlantaHawks: Atlanta Hawks
steroids: steroids
weightlifting: weightlifting
Connecticut: Connecticut
shiba: shiba
Allsvenskan: Allsvenskan
lesdom: lez dom
thetagang: the tagang
Techno: Techno
Kawaiiikitten: Kawaii kitten
nhentai: nhentai
asian_gifs: asian GIFS
lastweektonight: last week tonight
WTFwish: WTF wish
tailplug: tail plug
russiangirls: russian girls
dekaihentai: dekai hentai
CardiB: Cardi B
summonerswar: summoners war
COVID19positive: COVID 19 positive
ebonyhomemade: ebony homemade
CompetitiveHS: Competitive HS
Minneapolis: Minneapolis
singularity: singularity
thewitcher3: the witcher 3
shittybattlestations: shitty battlestations
aoe2: aoe 2
greysanatomy: grey's anatomy
writers: writers
Browns: Browns
Porsche: Porsche
feminineboys: feminine boys
AsianThroats: Asian Throats
doggos: doggos
bikewrench: bike wrench
TeamSolomid: Team Solo mid
SpaceBuckets: Space Buckets
datbuttfromthefront: dat butt from the front
ChineseLanguage: Chinese Language
HungryArtists: Hungry Artists
cosplayers: cosplayers
brokengifs: broken gifs
BoredandIgnored: Bored and Ignored
tscum: tscum
satisfying: satisfying
AlbumBabes: Album Babes
pansexual: pansexual
ravens: ravens
WhatAWeeb: What A Weeb
NSFW_Clothed: NSFW Clothed
shieldbro: shield bro
paydaytheheist: payday the heist
EtherMining: Ether Mining
BatmanArkham: Batman Arkham
PornGifs: Porn GIFS
BoobsInAction: Boobs In Action
whatsthisworth: what's this worth
GermansGoneWild: Germans Gone Wild
RelayForReddit: Relay For Reddit
ultrawidemasterrace: ultrawide master race
StreetMartialArts: Street Martial Arts
metalworking: metal working
3Dmodeling: 3D modeling
Wicca: Wicca
kratom: kratom
onlyfanschicks: onlyfans chicks
martialarts: martial arts
KyliePage: Kylie Page
CaughtFucking: Caught Fucking
interiordecorating: interior decorating
Ashe_Maree: Ashe Maree
MalesMasturbating: Males Masturbating
raceplay: race play
FractalPorn: Fractal Porn
CoinBase: Coin Base
Tori_Black: Tori Black
nsfwanimegifs: nsfw anime GIFS
pittsburgh: Pittsburgh
sissykik: sissy kik
BabesNSFW: Babes NSFW
analgonewild: anal gone wild
lightsabers: lightsabers
squirtinggonewild: squirting gone wild
FilthyAsians: Filthy Asians
InfowarriorRides: Infowarrior Rides
GrandTheftAutoV_PC: Grand Theft Auto V PC
HomemadePorn: Homemade Porn
madison_ivy: madison ivy
Balls: Balls
gradadmissions: grad admissions
Mid_Century: Mid Century
Archaeology: Archaeology
SchoolgirlsXXX: Schoolgirls XXX
WorldofTanks: World of Tanks
sonos: sonos
DisneyPlus: Disney Plus
JustGuysBeingDudes: Just Guys Being Dudes
blurrypicturesofcats: blurry pictures of cats
energy: energy
fuckyeahdrunksluts: fuck yeah drunk sluts
cactus: cactus
JackSucksAtLife: Jack Sucks At Life
BestOfStreamingVideo: Best Of Streaming Video
Quebec: Quebec
gaycumsluts: gay cum sluts
MovieMistakes: Movie Mistakes
researchchemicals: research chemicals
AustralianPolitics: Australian Politics
hungary: hungary
malelifestyle: male lifestyle
EmoGirlsFuck: Emo Girls Fuck
FootFetish: Foot Fetish
singing: singing
theydidthemonstermath: they did the monster math
sextingfriendfinder: sexting friend finder
CPTSD: CPTSD
pureasoiaf: pureasoiaf
after_the_shot: after the shot
YourJokeButWorse: Your Joke But Worse
stunfisk: stunfisk
sources4porn: sources for porn
KatyaClover: Katya Clover
cookingtonight: cooking tonight
felching: felching
SalsaSnobs: Salsa Snobs
asslick: ass lick
DJs: DJs
MomSonIncest: Mom Son Incest
3DPorncraft: 3D Porncraft
StarWarsEU: Star Wars EU
JenniferLawrence: Jennifer Lawrence
electricvehicles: electric vehicles
Brazzers: Brazzers
nsfwCelebArchive: nsfw Celeb Archive
GsSpot: G's Spot
naughtyinpublic: naughty in public
discordservers: discord servers
AnimalsBeingMoms: Animals Being Moms
bongbeauty: bong beauty
Deltarune: Deltarune
cakedecorating: cake decorating
LogitechG: Logitech G
HipHopGoneWild: Hip Hop Gone Wild
intj: intj
gratefuldead: grateful dead
cottontails: cottontails
ProgressiveGrowth: Progressive Growth
GIMP: GIMP
HotButts: Hot Butts
askcarsales: ask car sales
HentaiPetgirls: Hentai Petgirls
CannabisExtracts: Cannabis Extracts
AraAra: Ara Ara
Paizuri: Paizuri
pegging_unkinked: pegging un kinked
NBASpurs: NBA Spurs
ThreadKillers: Thread Killers
ubius: ubius
buildapcsalesuk: buildapcsalesuk
JapaneseFood: Japanese Food
PerkyChubby: Perky Chubby
HiTMAN: Hi TMAN
ScandinavianInterior: Scandinavian Interior
mcservers: mcservers
AskHR: Ask HR
FortniteCreative: Fortnite Creative
phr4r: phr4r
upherbutt: upherbutt
TheRareOnes: The Rare Ones
TalesFromTheSquadCar: Tales From The Squad Car
Pathfinder_RPG: Pathfinder RPG
GinaValentina: Gina Valentina
NEO: NEO
recipegifs: recipegifs
Femaleorgasmdenial: Female orgasm denial
sketches: sketches
netflixwitcher: netflix witcher
milanavayntrub: milana vayntrub
lady_in_the_streets: lady in the streets
netolab: netolab
SonyAlpha: Sony Alpha
Fireteams: Fireteams
latinaporn: latina porn
StealthVibes: Stealth Vibes
counterstrike: counter strike
LegalTeensGW: Legal Teens GW
Omeglesex: Omegle sex
ACPocketCamp: AC Pocket Camp
KGBTR: KGBTR
cannabiscultivation: cannabis cultivation
postorgasm: post orgasm
YanetGarcia: Yanet Garcia
wallpaperengine: wallpaper engine
showergirls: shower girls
SmallYTChannel: Small YT Channel
croatia: croatia
pantyhose: pantyhose
JapaneseUncensored: Japanese Uncensored
denvernuggets: denver nuggets
swoleacceptance: swole acceptance
MtF: Mt F
nsfwcelebs: nsfw celebs
ReverseEngineering: Reverse Engineering
AssVsBoobs: Ass Vs Boobs
alternativeart: alternative art
abandoned: abandoned
soccercirclejerk: soccer circle jerk
BlackWorldOrder: Black World Order
surfing: surfing
Sexy_Asians: Sexy Asians
BlackLivesMatter: Black Lives Matter
OCPoetry: OC Poetry
greece: greece
RealBeesFakeTopHats: Real Bees Fake Top Hats
Dollywinks: Dolly winks
JerkOffToDesiCelebs: Jerk Off To Desi Celebs
Busty: Busty
steam_giveaway: steam giveaway
womenintrouble: women in trouble
Notion: Notion
groestlcoin: groestlcoin
ACT: ACT
Seethroughyogapants: See through yoga pants
onoffcollages: on off collages
Tomorrowland: Tomorrowland
OsuSkins: Osu Skins
cutouts: cutouts
NonBinary: Non Binary
onlyfanshottest: onlyfans hottest
autism: autism
Liberal: Liberal
trapsarentgay: traps aren't gay
sailing: sailing
redhead: redhead
ftm: ftm
amazonreviews: amazon reviews
NailArt: Nail Art
AskNYC: Ask NYC
wownoob: wow noob
Cryptozoology: Cryptozoology
lookatmydog: look at my dog
SharedBPM: Shared BPM
ems: EMS
cat: cat
blacked: blacked
Emily_Lynne: Emily Lynne
Stadia: Stadia
OnlyAmateurPorn: Only Amateur Porn
mylittlepony: my little pony
RealJilling: Real Jilling
easyrecipes: easy recipes
CumAgain: Cum Again
WaifusOnCouch: Waifus On Couch
chefknives: chef knives
cougars: cougars
TheArtistStudio: The Artist Studio
AmateurArchives: Amateur Archives
NewParents: New Parents
bikecommuting: bike commuting
C_Programming: C Programming
DeTrashed: De Trashed
watersports: water sports
xxketo: xx keto
SuperAthleteGifs: Super Athlete Gifs
justforsocialmedia: just for social media
Existentialism: Existentialism
suns: suns
burgers: burgers
birdpics: bird pics
TheThiccness: The Thiccness
shecame: she came
BellaThorne: Bella Thorne
breastsucking: breast sucking
ChurchOfTheBBC: Church Of The BBC
BoltedOnBooty: Bolted On Booty
OnlyFansBusty: OnlyFans Busty
gamemusic: game music
Strippersonthejob: Strippers on the job
WarplanePorn: Warplane Porn
papertowns: paper towns
R6ProLeague: R6 Pro League
explainlikeIAmA: explain like I Am A
InstaThots: Insta Thots
thesopranos: the sopranos
snackexchange: snack exchange
antinatalism: antinatalism
zen: zen
nova: nova
audiodrama: audio drama
VintageBabes: Vintage Babes
DestructionPorn: Destruction Porn
koreanvariety: korean variety
physicsmemes: physics memes
Dragonballsuper: Dragonball super
Honda: Honda
China_Flu: China Flu
YangForPresidentHQ: Yang For President HQ
Behzinga: Behzinga
washingtonwizards: washington wizards
inthenews: in the news
VocabWordOfTheDay: Vocab Word Of The Day
kodi: kodi
TheEroticSalon: The Erotic Salon
careeradvice: career advice
HentaiBreeding: Hentai Breeding
boypussy: boy pussy
unclebens: uncle bens
maryland: maryland
BarbieWorld: Barbie World
nashville: nashville
riverdale: riverdale
Prisonwallet: Prison Wallet
PornoCasino: Porno Casino
SubredditSimMeta: Subreddit Sim Meta
learnjava: learnjava
dune: dune
timberwolves: timberwolves
lawschooladmissions: law school admissions
Cubers: Cubers
RASPBERRY_PI_PROJECTS: RASPBERRY PI PROJECTS
paris: paris
StudentLoans: Student Loans
PokemonTCG: Pokemon TCG
hotwifetexts: hot wife texts
CoconutKitty: Coconut Kitty
JackAndJill: Jack And Jill
sad: sad
Audi: Audi
cumflation: cumflation
altcoin: altcoin
Erotica: Erotica
PokemonROMhacks: Pokemon ROM hacks
CartoonPornNSFW: Cartoon Porn NSFW
JuiceWRLD: Juice WRLD
GWAustralia: GW Australia
FilthyFrank: Filthy Frank
waterporn: water porn
Indiemakeupandmore: Indie makeup and more
Israel: Israel
HazbinHotel: Hazbin Hotel
TheAdventureZone: The Adventure Zone
cosplayonoff: cosplay on off
W2S: W2S
AskParents: Ask Parents
sugarlifestyleforum: sugar lifestyle forum
Gaming4Gamers: Gaming 4 Gamers
googlemapsshenanigans: google maps shenanigans
bigboobproblems: big boob problems
churchporn: church porn
90s: 90s
DebateReligion: Debate Religion
CumSwallowing: Cum Swallowing
Skookum: Skookum
VPN: VPN
JailyneOjedaOchoa: Jailyne Ojeda Ochoa
sadcats: sad cats
czech: czech
WackyTicTacs: Wacky Tic Tacs
Thighs: Thighs
chiisaihentai: chiisai hentai
d100: d100
MakeUpAddictionUK: Make Up Addiction UK
gunpolitics: gun politics
MouthWideOpen: Mouth Wide Open
OnlyfansXXX: Onlyfans XXX
BabyCorgis: Baby Corgis
slaythespire: slay the spire
NightOutGirls: Night Out Girls
Kappa: Kappa
incest: incest
TheBestGifsNSFW: The Best Gifs NSFW
misfits: misfits
killedthecameraman: killed the cameraman
FlexiGirls: Flexi Girls
suspiciousquotes: suspicious quotes
twice: twice
infj: infj
MakeupRehab: Makeup Rehab
bikinibridge: bikini bridge
Lionessintherain: Lioness in the rain
ghettoglamourshots: ghetto glamour shots
joinsquad: join squad
Switzerland: Switzerland
Izlam: Izlam
reversecowgirl: reverse cowgirl
straightturnedgay: straight turned gay
NoPoo: No Poo
Virginia: Virginia
bookshelf: bookshelf
Lena_The_Plug: Lena The Plug
3dshacks: 3dshacks
RetroGamePorn: Retro Game Porn
Mandalorian: Mandalorian
WillNE: Will NE
AskScienceDiscussion: Ask Science Discussion
Korean: Korean
whoooosh: whoooosh
DirtySexyKikPals: Dirty Sexy Kik Pals
CleaningTips: Cleaning Tips
Shemale_Big_Cock: Shemale Big Cock
OnlyFansPetite: OnlyFans Petite
Gundam: Gundam
smarthome: smart home
hittableFaces: hittable Faces
chastity: chastity
famiL: fami L
DeadEyes: Dead Eyes
Positive_News: Positive News
Instagrammodels: Instagram models
wisconsin: wisconsin
flyfishing: fly fishing
Basketball: Basketball
TSonFM: TS on FM
translator: translator
AwaitingCum: Awaiting Cum
Nekomimi: Nekomimi
NakedOnStage: Naked On Stage
lordoftherings: lord of the rings
cogsci: cog sci
msp: msp
OrganizationPorn: Organization Porn
windygirk: windygirk
Shooshtime: Shooshtime
Brittanya_Razavi_: Brittanya Razavi
magnetfishing: magnet fishing
glassheads: glassheads
NicoleDobrikov: Nicole Dobrikov
FitModels: Fit Models
ElsieHewitt: Elsie Hewitt
LAClippers: LA Clippers
codyko: codyko
Dominated: Dominated
FurryPornSubreddit: Furry Porn Subreddit
NFL_Draft: NFL Draft
flicks: flicks
FuckNestle: Fuck Nestle
climbharder: climb harder
Only_Amateurs: Only Amateurs
DamnASS: Damn ASS
HighHeels: High Heels
Fire: Fire
MicroBikini: Micro Bikini
CatsInSinks: Cats In Sinks
RedditInReddit: Reddit In Reddit
tmobile: t mobile
SkyrimMemes: Skyrim Memes
FirstInsertion: First Insertion
onlyfansadvice: onlyfans advice
MuayThai: Muay Thai
snes: snes
Scarymovies: Scary movies
morbidlybeautiful: morbidly beautiful
geography: geography
BralessForever: Braless Forever
TheHandmaidsTale: The Handmaids Tale
ropes: ropes
manyvids: manyvids
SkylarVox: Skylar Vox
Autoflowers: Autoflowers
fairytail: fairy tail
AllKindOfPorn: All Kind Of Porn
vita: vita
eGamerGirl: e Gamer Girl
phclassifieds: phclassifieds
jav: jav
TrueAtheism: True Atheism
AMADisasters: AMA Disasters
cumlube: cum lube
SubsIFellFor: Subs I Fell For
PsychologicalTricks: Psychological Tricks
Transmogrification: Transmogrification
Sexyvelma: Sexy Velma
Starlink: Starlink
HairDye: Hair Dye
sideboob: side boob
riskofrain: risk of rain
KingkillerChronicle: Kingkiller Chronicle
rawdenim: raw denim
pornwithsounds: porn with sounds
SophieM: Sophie M
Sissy: Sissy
NSFW_Tributes: NSFW Tributes
christmas: christmas
backrooms: backrooms
criterion: criterion
AskSocialScience: Ask Social Science
Portal: Portal
TsundereSharks: Tsundere Sharks
VinylDeals: Vinyl Deals
SuckingItDry: Sucking It Dry
MelodyMarks: Melody Marks
Journaling: Journaling
UnexplainedPhotos: Unexplained Photos
Socialism_101: Socialism 101
DevilMayCry: Devil May Cry
MilitaryStories: Military Stories
SwitchHacks: Switch Hacks
Magic: Magic
Artistic_Hentai: Artistic Hentai
undelete: undelete
SovietWomble: Soviet Womble
EnoughTrumpSpam: Enough Trump Spam
doordash: doordash
indiegames: indie games
estoration: estoration
MaleFashionMarket: Male Fashion Market
rance: rance
tbulges: t bulges
HeistTeams: Heist Teams
ParentsAreFuckingDumb: Parents Are Fucking Dumb
UtahJazz: Utah Jazz
CompTIA: Comp TIA
BisexualTeens: Bisexual Teens
HumanTippyTaps: Human Tippy Taps
drugscirclejerk: drugs circle jerk
Chromecast: Chromecast
NewsOfTheStupid: News Of The Stupid
CheatingCaptions: Cheating Captions
irlsmurfing: irl smurfing
SideLips: Side Lips
dominican_onlyfan2: dominican onlyfan2
HomemadeGIFs: Homemade GIFs
Unclejokes: Uncle jokes
thepiratebay: the pirate bay
ValorantCompetitive: Valorant Competitive
botany: botany
guitarporn: guitar porn
wedding: wedding
Xcom: Xcom
airplaneears: airplane ears
girlsdoporn: girls do porn
softies: softies
OriginalBabes: Original Babes
SonicTheHedgehog: Sonic The Hedgehog
tldr: tl dr
Pokemonart: Pokemon art
WomenOfColour: Women Of Colour
Battlecars: Battle cars
drugstoreMUA: drugstore MUA
motogp: moto gp
TropicalWeather: Tropical Weather
yourmomshousepodcast: your mom's house podcast
Anjelica_Ebbi: Anjelica Ebbi
shittymobilegameads: shitty mobile game ads
indianews: indianews
RedditForGrownups: Reddit For Grownups
lifting: lifting
HostileArchitecture: Hostile Architecture
Cumontits: Cum on tits
iOSProgramming: iOS Programming
TwoXSex: Two X Sex
AlinaLopez: Alina Lopez
chrome: chrome
oculusnsfw: oculus nsfw
FaceFirstNSFW: Face First NSFW
OnlyFans: Only Fans
SoCalR4R: So Cal R4R
shittytattoos: shitty tattoos
Komi_san: Komi san
shittytechnicals: shitty technicals
detroitlions: detroit lions
see: see
beatsaber: beat saber
Machinists: Machinists
blacktears: black tears
30ROCK: 30 ROCK
Cowgirl_Riding_Babes: Cowgirl Riding Babes
AnimalsBeingConfused: Animals Being Confused
neuroscience: neuroscience
Construction: Construction
NonZeroDay: Non Zero Day
DenverBroncos: Denver Broncos
Throats: Throats
IndiaInvestments: India Investments
UncensoredAsian: Uncensored Asian
vegetablegardening: vegetable gardening
Chadtopia: Chadtopia
progmetal: prog metal
Cartoon_Porn: Cartoon Porn
ShitCosmoSays: Shit Cosmo Says
Indiana: Indiana
F1Porn: F1 Porn
UpvotedBecauseBoobs: Upvoted Because Boobs
ECE: ECE
cat_girls: cat girls
CruciblePlaybook: Crucible Playbook
ashkashhh: ashkashhh
BestSnapchatNudes: Best Snapchat Nudes
Bellabrookz: Bella Brookz
DadsAndBoys: Dads And Boys
PornCum: Porn Cum
loltyler1: loltyler1
OkBubbyRetard: Ok Bubby Retard
syriancivilwar: syrian civil war
spiders: spiders
IndianFood: Indian Food
hinduism: hinduism
JustNoSO: Just No SO
newyorkcity: new york city
Trucks: Trucks
husky: husky
ihavereddit: i have reddit
adultery: adultery
TooBig: Too Big
whatsthisrock: whatsthisrock
ThickFit: Thick Fit
Pantyfetish: Panty fetish
animalcrossingdesign: animal crossing design
BanderitaX: BanderitaX
FeetToesAndSocks: Feet Toes And Socks
LazarBeam: Lazar Beam
fnafcringe: fnaf cringe
applehelp: apple help
RoastMyCar: Roast My Car
AshleyTervort: Ashley Tervort
shesgonnacum: shesgonna cum
MBA: MBA
NationalPark: National Park
orlando: orlando
cocaine: cocaine
Healthy_Recipes: Healthy Recipes
northernireland: northern ireland
HollowKnightMemes: Hollow Knight Memes
scuba: scuba
badassanimals: badass animals
AdobeIllustrator: Adobe Illustrator
NYGiants: NY Giants
Nicki_Minaj: Nicki Minaj
ElectricalEngineering: Electrical Engineering
Bondage_Porn: Bondage Porn
gaypornhunters: gay porn hunters
kings: kings
metart: met art
Mordhau: Mordhau
PetaJensen: Peta Jensen
cheating_stories: cheating stories
analytics: analytics
Residency: Residency
helgalovekaty: helgalovekaty
nattyorjuice: natty or juice
mildlyvagina: mildly vagina
PoliticsNSFW: Politics NSFW
Finanzen: Finanzen
natureporn: nature porn
pharmacy: pharmacy
GYM: GYM
corychase: cory chase
Tronix: Tronix
dreamjobs: dream jobs
watch_dogs: watch dogs
realsexyselfies: real sexy selfies
HotWifeLifestyle: Hot Wife Lifestyle
judo: judo
catsonglass: cats on glass
MawInstallation: Maw Installation
Stock_Picks: Stock Picks
britishcolumbia: british columbia
KuroiHada: Kuroi Hada
ballsucking: ballsucking
DaniDev: Dani Dev
Hololewd: Hololewd
Standup: Standup
Ubiquiti: Ubiquiti
hotsauce: hotsauce
LEAKEDonlyfans: LEAKEDonlyfans
armoredwomen: armored women
corinnakopf: corinnakopf
Workbenches: Workbenches
UnexpectedThanos: Unexpected Thanos
CoronavirusMemes: Coronavirus Memes
GamerPals: Gamer Pals
mapmaking: mapmaking
Anthropology: Anthropology
Hotdogging: Hotdogging
rnb: rnb
SugarBaby: Sugar Baby
HorriblyDepressing: Horribly Depressing
HoldMyKibble: Hold My Kibble
ketobeginners: keto beginners
CollegeInitiation: College Initiation
R4R30Plus: R4R30Plus
bapcsalescanada: bapcsalescanada
KristyBlack: Kristy Black
girlsinleggings: girls in leggings
BigTitsButClothed: Big Tits But Clothed
HumanFleshlight: Human Fleshlight
psychotherapy: psychotherapy
ExplainLikeImCalvin: Explain Like Im Calvin
ElsaGate: Elsa Gate
BBCsissies: BBC sissies
Thatsabooklight: That's a book light
ImaginaryWarhammer: Imaginary Warhammer
illusionporn: illusion porn
WorldOfWarships: World Of Warships
Joymii: Joymii
SnapChad: Snap Chad
AsiansGoneErotic: Asians Gone Erotic
twerk: twerk
aspergers: aspergers
oregon: oregon
bassfishing: bass fishing
DogsAndPlants: Dogs And Plants
Otters: Otters
dotnet: dotnet
NoFeeAC: No Fee AC
Cheese: Cheese
ArtHistory: Art History
lindseypelas: lindsey pelas
FayeReagan: Faye Reagan
DillionHarper: Dillion Harper
InstaSnapsAndMore: Insta Snaps And More
IPTV: IPTV
netsecstudents: netsec students
terrariums: terrariums
EnhancedFucktoys: Enhanced Fucktoys
NSFWPublic: NSFW Public
holdmybeaker: hold my beaker
garlicoin: garlicoin
MelissaDebling: Melissa Debling
HypnoHentai: Hypno Hentai
DarwinAwards: Darwin Awards
HBOGameofThrones: HBO Game of Thrones
cardsagainsthumanity: cards against humanity
whatstheword: what's the word
MegnuttOF: Megnutt OF
washingtonNFL: washington NFL
SacredGeometry: Sacred Geometry
absoluteunit: absolute unit
pokemongotrades: pokemon go trades
TwinCities: Twin Cities
DSLs: DSLs
women: women
mspaint: mspaint
Currentlytripping: Currently tripping
scambait: scambait
ChanelUzi: Chanel Uzi
cuminsideme: cum inside me
evangelionmemes: evangelion memes
continuityporn: continuity porn
LilPeep: Lil Peep
SWGalaxyOfHeroes: SW Galaxy Of Heroes
7daystodie: 7 days to die
TheBestOfAmazon: The Best Of Amazon
BBWVideos: BBW Videos
standingout: standing out
AlexisRen: Alexis Ren
BeautifulTitsAndAss: Beautiful Tits And Ass
PressureCooking: Pressure Cooking
SubsYouFellFor: Subs You Fell For
magick: magick
americandad: american dad
bullybackfire: bully backfire
rally: rally
TheWeeknd: The Weeknd
nihilism: nihilism
secretlittle: secret little
JerkingHimOntoHer: Jerking Him Onto Her
BonersInPublic: Boners In Public
asiangirlsforwhitemen: asian girls for white men
AskWomenOver30: Ask Women Over 30
petplay: petplay
NSFW_5seconds: NSFW 5 seconds
classiccars: classic cars
RedditInTheKitchen: Reddit In The Kitchen
massachusetts: massachusetts
socalgonewild: socal gonewild
shortcircuit: short circuit
futanari_Comics: futanari Comics
mauerstrassenwetten: mauerstrassenwetten
AfterTheShot: After The Shot
MapsWithoutNZ: Maps Without NZ
amateurnudeswithface: amateur nudes with face
MLBTheShow: MLB The Show
SwordOrSheath: Sword Or Sheath
UniversityofReddit: University of Reddit
hamiltonmusical: hamilton musical
puzzles: puzzles
AmateurGroups: Amateur Groups
LSAT: LSAT
18plusGIFs: 18plus GIFs
neutralnews: neutral news
TwerkingPorn: Twerking Porn
Lifebrotips: Life bro tips
mobilelegends: mobile legends
sexting: sexting
polyamoryR4R: polyamory R4R
Enhancement: Enhancement
Cameras: Cameras
redditbay: reddit bay
DestroyedTanks: Destroyed Tanks
RLFashionAdvice: RL Fashion Advice
BackshotsHQ: Backshots HQ
guineapigs: guinea pigs
bartenders: bartenders
computers: computers
SydneySweeney: Sydney Sweeney
PornMemes: Porn Memes
es: es
incremental_games: incremental games
footjobs: footjobs
GhostRecon: Ghost Recon
funsizedasian: funsized asian
needforspeed: need for speed
CircleofTrust: Circle of Trust
OppaiLove: Oppai Love
Lightbulb: Lightbulb
AzurLewd: Azur Lewd
amberhayes: amber hayes
Beekeeping: Beekeeping
Unity2D: Unity2D
GenshinImpactHentai: Genshin Impact Hentai
sexygirlsinjeans: sexy girls in jeans
FreeOnlyFansPage: Free OnlyFans Page
lifeisstrange: life is strange
muslimgirls: muslim girls
MaddenUltimateTeam: Madden Ultimate Team
megalinks: megalinks
cromch: cromch
GrabHerTitties: Grab Her Titties
BrazzersNSFW: Brazzers NSFW
4x4: 4x4
CovIdiots: Cov Idiots
fuckmywife: fuck my wife
RoughRomanMemes: Rough Roman Memes
Morrowind: Morrowind
AppalachianTrail: Appalachian Trail
BootyfulWomen: Bootyful Women
leotards: leotards
CumCannonAddicts: Cum Cannon Addicts
longhair: long hair
cute: cute
cookingvideos: cooking videos
steinsgate: steins gate
chadsriseup: chads rise up
zombies: zombies
circojeca: circojeca
BabyYoda: Baby Yoda
dubai: dubai
streetart: street art
amateur_threesomes: amateur threesomes
webcamgirlsnsfw: webcam girls NSFW
rockhounds: rockhounds
seashanties: sea shanties
Archery: Archery
investimentos: investimentos
RiskyPorn: Risky Porn
xmen: xmen
Epstein: Epstein
Miata: Miata
legwrap: leg wrap
CriticalTheory: Critical Theory
IWantItSoBad: I Want It So Bad
FFVIIRemake: FF VII Remake
BIGTITTYGOTHGF: BIG TITTY GOTH GF
DealsReddit: Deals Reddit
AsianBlowjobs: Asian Blowjobs
HarryPotterMemes: Harry Potter Memes
GirlsinStripedSocks: Girls in Striped Socks
AskTrumpSupporters: Ask Trump Supporters
yakuzagames: yakuzagames
ukthots: ukthots
weekendgunnit: weekendgunnit
worldofpvp: world of pvp
TameImpala: Tame Impala
allpornnsfw: allpornnsfw
reptiles: reptiles
Emo: Emo
badphilosophy: bad philosophy
sluts: sluts
smashbros34: smashbros34
WrestleFap: WrestleFap
indonesia: indonesia
fetish: fetish
techwearclothing: techwear clothing
NSFWBOX: NSFWBOX
SelfSufficiency: Self Sufficiency
Mooning: Mooning
buffalobills: buffalo bills
BrutalBeatdowns: Brutal Beatdowns
bestofcollege: best of college
AsianPussy: Asian Pussy
AsianAss: Asian Ass
simpsonsshitposting: simpsons shitposting
Random_Acts_Of_Sex: Random Acts Of Sex
seinfeldgifs: seinfeld gifs
NSFW_Cams: NSFW Cams
FetishLife: Fetish Life
HotWifeRequests: Hot Wife Requests
worldevents: world events
PPC: PPC
MissLexa: Miss Lexa
randomsexygifs: random sexy gifs
SteamGameSwap: Steam Game Swap
FBIOpenUp: FBI Open Up
gallifrey: gallifrey
handinpanties: hand in panties
CamOrgasm: Cam Orgasm
Anarchy101: Anarchy 101
trump: trump
LPOTL: LPOTL
PornhubAmateurs: Pornhub Amateurs
kotor: kotor
Target: Target
unexpectedsex: unexpected sex
motorsportsstreams: motorsports streams
Barca: Barca
funpiece: funpiece
Columbus: Columbus
macsetups: mac setups
Fairytail_hentai: Fairytail hentai
Siswet19: Siswet19
bigtittygothegg: big titty goth egg
wallstreetbetstest: wall street bets test
YouFellForItFool: You Fell For It Fool
HYPERSCAPE: HYPERSCAPE
toofers: toofers
VioletMyers: Violet Myers
GTBAE: GTBAE
CumTornado: Cum Tornado
ClothingKink: Clothing Kink
cardistry: cardistry
GirlsinLaceFishnets: Girls in Lace Fishnets
TrashyPorn: Trashy Porn
flatchests: flat chests
GreatXboxDeals: Great Xbox Deals
FreaksNLeaks: Freaks N Leaks
HappyWoofGifs: Happy Woof Gifs
Morgpie: Morgpie
ihaveihaveihavereddit: ihaveihaveihavereddit
F1Game: F1 Game
TrueDetective: True Detective
DaftPunk: Daft Punk
bonehealingjuice: bone healing juice
Pyongyang: Pyongyang
skirtnoshirt: skirt no shirt
germanshepherds: german shepherds
TerrainBuilding: Terrain Building
Antiques: Antiques
Bikeporn: Bike porn
amiibo: amiibo
TowerofGod: Tower of God
dreampop: dream pop
PrettyGirlsUglyFaces: Pretty Girls Ugly Faces
LaurenSummer: Lauren Summer
buildmeapc: build me a pc
awwnverts: awwnverts
Carpentry: Carpentry
Fantasy_Football: Fantasy Football
DarthJarJar: Darth Jar Jar
Megturney: Megturney
LizKatz: Liz Katz
Market76: Market76
BaileyJay: Bailey Jay
Nailpolish: Nail polish
spikes: spikes
Watchmen: Watchmen
FifthWorldPics: Fifth World Pics
Colombia: Colombia
Notakeonlythrow: Notakeonlythrow
gonecivil: gonecivil
BlancNoir: Blanc Noir
Volumeeating: Volume eating
donkybooties: donkybooties
traderjoes: trader joes
shemale_gifs: shemale gifs
HomeKit: Home Kit
NOLAPelicans: NOLA Pelicans
AsABlackMan: As A Black Man
Purrito: Purrito
dogs_getting_dogs: dogs getting dogs
AndroidQuestions: Android Questions
DetroitPistons: Detroit Pistons
dechonkers: dechonkers
MobileWallpaper: Mobile Wallpaper
beyonce: beyonce
SelenaGomez: Selena Gomez
momson: momson
trailmeals: trail meals
Saints: Saints
BrieLarson: Brie Larson
medievaldoctor: medieval doctor
IndieDev: Indie Dev
triathlon: triathlon
beginnerfitness: beginner fitness
Hot_Women_Gifs: Hot Women Gifs
Daddy: Daddy
WomenLookingDown: Women Looking Down
SexWorkersOnly: Sex Workers Only
rimjob: rimjob
cemu: cemu
Multicopter: Multicopter
NYYankees: NY Yankees
CoronavirusUK: Coronavirus UK
Xenoblade_Chronicles: Xenoblade Chronicles
rapefantasies: rape fantasies
deepseacreatures: deep sea creatures
BadChoicesGoodStories: Bad Choices Good Stories
Goatparkour: Goatparkour
cocklady: cock lady
OldSchoolCelebs: Old School Celebs
PetiteFashionAdvice: Petite Fashion Advice
SleepPorn: Sleep Porn
Ornithology: Ornithology
gfur: gfur
AverageAnimeTiddies: Average Anime Tiddies
JustBBlack: Just B Black
MeatlessMealPrep: Meatless Meal Prep
Volkswagen: Volkswagen
animebodysuits: anime bodysuits
SQL: SQL
NZXT: NZXT
MoeMorphism: Moe Morphism
LexiBelle: Lexi Belle
MemesIRL: Memes IRL
AliensAmongUs: Aliens Among Us
CompetitiveTFT: Competitive TFT
ALLTHEANIMALS: ALL THE ANIMALS
RenewableEnergy: Renewable Energy
SocialistRA: Socialist RA
mentalillness: mental illness
Ebay: Ebay
TheBluePill: The Blue Pill
deathnote: death note
Norway: Norway
django: django
accidentalswastika: accidental swastika
Anxietyhelp: Anxiety help
PokemonLetsGo: Pokemon Lets Go
DaenerysWinsTheThrone: Daenerys Wins The Throne
JustOneBoob: Just One Boob
spain: spain
Best_tattoos: Best tattoos
Miami: Miami
NotADildo: Not A Dildo
adamsilverfanpage: adamsilverfanpage
supportlol: supportlol
tacobell: taco bell
IShouldBuyABoat: I Should Buy A Boat
StarWarsTattoo: Star Wars Tattoo
blackops3: black ops 3
coys: coys
identifythisfont: identify this font
taiwan: taiwan
SuddenlyIncest: Suddenly Incest
Bhad__Bhabie: Bhad Bhabie
Dbz34: Dbz34
MrsPoindexter: Mrs Poindexter
CraftBeer: Craft Beer
BestBooties: Best Booties
Ladyboys: Ladyboys
ZettaiRyouiki: Zettai Ryouiki
CaughtPublic: Caught Public
pacers: pacers
mythology: mythology
GirlsWearingVS: Girls Wearing VS
juststart: juststart