announcements: announcements
funny: funny
AskReddit: Ask Reddit
gaming: gaming
aww: aww
Music: Music
pics: pics
science: science
worldnews: world news
todayilearned: today i learned
videos: videos
movies: movies
news: news
Showerthoughts: Shower thoughts
EarthPorn: Earth Porn
IAmA: I Am A
food: food
gifs: gifs
askscience: ask science
Jokes: Jokes
LifeProTips: Life Pro Tips
explainlikeimfive: explain like i five
books: books
Art: Art
nottheonion: not the onion
DIY: DIY
mildlyinteresting: mildly interesting
sports: sports
space: space
gadgets: gadgets
blog: blog
Documentaries: Documentaries
photoshopbattles: photoshop battles
GetMotivated: Get Motivated
tifu: tifu
UpliftingNews: Uplifting News
listentothis: listen to this
television: television
dataisbeautiful: data is beautiful
history: history
philosophy: philosophy
InternetIsBeautiful: Internet Is Beautiful
memes: memes
Futurology: Futurology
WritingPrompts: Writing Prompts
OldSchoolCool: Old School Cool
nosleep: no sleep
personalfinance: personal finance
creepy: creepy
TwoXChromosomes: Two X Chromosomes
technology: technology
wallstreetbets: wall street bets
AdviceAnimals: Advice Animals
wholesomememes: wholesome memes
Fitness: Fitness
interestingasfuck: interesting as fuck
politics: politics
WTF: WTF
travel: travel
oddlysatisfying: oddly satisfying
BlackPeopleTwitter: Black People Twitter
bestof: best of
lifehacks: life hacks
facepalm: facepalm
leagueoflegends: league of legends
Minecraft: Minecraft
relationship_advice: relationship advice
pcmasterrace: PC Master Race
me_irl: me in real life
Whatcouldgowrong: What could go wrong
dankmemes: dank memes
NatureIsFuckingLit: Nature Is Fucking Lit
Tinder: Tinder
PS4: PS4
AnimalsBeingBros: Animals Being Bros
nextfuckinglevel: next fucking level
dadjokes: dad jokes
tattoos: tattoos
photography: photography
trippinthroughtime: trippin through time
BikiniBottomTwitter: Bikini Bottom Twitter
nba: NBA
AnimalsBeingJerks: Animals Being Jerks
buildapc: build a PC
Unexpected: Unexpected
FoodPorn: Food Porn
woahdude: woah dude
instant_regret: instant regret
reactiongifs: reaction gifs
gardening: gardening
Overwatch: Overwatch
PewdiepieSubmissions: Pewdiepie Submissions
boardgames: board games
AnimalsBeingDerps: Animals Being Derps
Damnthatsinteresting: Damn that's interesting
programming: programming
WatchPeopleDieInside: Watch People Die Inside
pokemon: pokemon
ContagiousLaughter: Contagious Laughter
mildlyinfuriating: mildly infuriating
Parenting: Parenting
PublicFreakout: Public Freakout
MadeMeSmile: Made Me Smile
pokemongo: pokemon go
EatCheapAndHealthy: Eat Cheap And Healthy
relationships: relationships
iphone: iPhone
itookapicture: I took a picture
NintendoSwitch: Nintendo Switch
malefashionadvice: male fashion advice
drawing: drawing
woodworking: woodworking
YouShouldKnow: You Should Know
xboxone: Xbox One
Games: Games
humor: humor
Outdoors: Outdoors
rarepuppers: rare puppers
Bitcoin: Bitcoin
nonononoyes: no no no yes
loseit: lose it
GifRecipes: Gif Recipes
gameofthrones: game of thrones
europe: europe
cats: cats
Awwducational: Awwducational
BetterEveryLoop: Better Every Loop
AmItheAsshole: Am I the Asshole
cursedcomments: cursed comments
soccer: soccer
dating_advice: dating advice
atheism: atheism
HighQualityGifs: High Quality Gifs
stocks: stocks
IdiotsInCars: Idiots In Cars
ChildrenFallingOver: Children Falling Over
NetflixBestOf: Netflix Best Of
MakeupAddiction: Makeup Addiction
pcgaming: PC Gaming
slowcooking: slow cooking
streetwear: streetwear
AskMen: Ask Men
HistoryPorn: History Porn
Cooking: Cooking
HistoryMemes: History Memes
Eyebleach: Eye bleach
CrappyDesign: Crappy Design
CryptoCurrency: Crypto Currency
confession: confession
recipes: recipes
Wellthatsucks: Well that sucks
offmychest: off my chest
teenagers: teenagers
backpacking: backpacking
apple: Apple
anime: anime
TrollYChromosome: Troll Y Chromosome
entertainment: entertainment
MurderedByWords: Murdered By Words
socialskills: social skills
howto: how to
keto: keto
trashy: trashy
cars: cars
horror: horror
DnD: DnD
Coronavirus: Coronavirus
scifi: sci fi
raspberry_pi: raspberry pi
biology: biology
battlestations: battle stations
HumansBeingBros: Humans Being Bros
OutOfTheLoop: Out Of The Loop
MovieDetails: Movie Details
BeAmazed: Be Amazed
frugalmalefashion: frugal male fashion
Android: Android
blackmagicfuckery: black magic fuckery
AskWomen: Ask Women
mac: Mac
DeepIntoYouTube: Deep Into YouTube
NoStupidQuestions: No Stupid Questions
youtubehaiku: youtube haiku
rickandmorty: rick and morty
learnprogramming: learn programming
RoastMe: Roast Me
KidsAreFuckingStupid: Kids Are Fucking Stupid
WhitePeopleTwitter: White People Twitter
coolguides: cool guides
Roadcam: Roadcam
reallifedoodles: real life doodles
wow: wow
electronicmusic: electronic music
dogs: dogs
ChoosingBeggars: Choosing Beggars
bodyweightfitness: bodyweight fitness
nfl: NFL
nintendo: Nintendo
insanepeoplefacebook: insane people facebook
foodhacks: food hacks
hardware: hardware
DestinyTheGame: Destiny The Game
starterpacks: starter packs
unpopularopinion: unpopular opinion
MealPrepSunday: Meal Prep Sunday
instantkarma: instant karma
blursedimages: blursed images
therewasanattempt: there was an attempt
camping: camping
hiphopheads: hip hop heads
HomeImprovement: Home Improvement
Sneakers: Sneakers
podcasts: podcasts
zelda: Zelda
Astronomy: Astronomy
likeus: like us
Design: Design
ArtefactPorn: Artefact Porn
whatisthisthing: what is this thing
ksi: KSI
ArtisanVideos: Artisan Videos
youseeingthisshit: you seeing this shit
yesyesyesyesno: yes yes yes yes no
indieheads: indie heads
FiftyFifty: Fifty Fifty
natureismetal: nature is metal
sex: sex
StarWars: Star Wars
femalefashionadvice: female fashion advice
MachineLearning: Machine Learning
shittyfoodporn: shitty food porn
investing: investing
nevertellmetheodds: never tell me the odds
PrequelMemes: Prequel Memes
JusticeServed: Justice Served
CozyPlaces: Cozy Places
hearthstone: hearthstone
HolUp: Hol Up
homestead: homestead
nasa: NASA
writing: writing
Frugal: Frugal
hacking: hacking
rareinsults: rare insults
comicbooks: comic books
JUSTNOMIL: JUST NO MIL
ThriftStoreHauls: Thrift Store Hauls
Graffiti: Graffiti
urbanexploration: urban exploration
Filmmakers: Filmmakers
assholedesign: asshole design
trees: trees
madlads: mad lads
dogecoin: dogecoin
Physics: Physics
spaceporn: space porn
hmmm: hmmm
PUBATTLEGROUNDS: PUBG
tipofmytongue: tip of my tongue
wallpaper: wallpaper
DunderMifflin: Dunder Mifflin
progresspics: progress pics
JapanTravel: Japan Travel
nutrition: nutrition
WeAreTheMusicMakers: We Are The Music Makers
savedyouaclick: saved you a click
solotravel: solo travel
marvelstudios: Marvel Studios
GamePhysics: Game Physics
educationalgifs: educational gifs
literature: literature
WinStupidPrizes: Win Stupid Prizes
quityourbullshit: quit your bullshit
crafts: crafts
astrophotography: astrophotography
Cinemagraphs: Cinemagraphs
AnimalCrossing: Animal Crossing
SketchDaily: Sketch Daily
math: math
holdmycosmo: hold my cosmo
HealthyFood: Healthy Food
MMA: MMA
bodybuilding: bodybuilding
comics: comics
PerfectTiming: Perfect Timing
iamverysmart: I Am Very Smart
Watches: Watches
baseball: baseball
legaladvice: legal advice
meme: meme
entitledparents: entitled parents
thewalkingdead: the walking dead
pennystocks: penny stocks
audiophile: audiophile
CampingandHiking: Camping and Hiking
FortNiteBR: Fortnite BR
CasualConversation: Casual Conversation
comedyheaven: comedy heaven
conspiracy: conspiracy
CollegeBasketball: College Basketball
MaliciousCompliance: Malicious Compliance
suggestmeabook: suggest me a book
technicallythetruth: technically the truth
mealtimevideos: mealtime videos
javascript: javascript
ProgrammerHumor: Programmer Humor
formula1: Formula 1
breakingbad: Breaking Bad
google: google
ATBGE: ATBGE
apexlegends: Apex Legends
ShittyLifeProTips: Shitty Life Pro Tips
StockMarket: Stock Market
SpecArt: Spec Art
CatastrophicFailure: Catastrophic Failure
EDM: EDM
MemeEconomy: Meme Economy
chemistry: chemistry
Economics: Economics
roadtrip: road trip
techsupport: tech support
compsci: computer science
Metal: Metal
hiking: hiking
MapPorn: Map Porn
DoesAnybodyElse: Does Anybody Else
childfree: childfree
running: running
KerbalSpaceProgram: Kerbal Space Program
PeopleFuckingDying: People Fucking Dying
UnresolvedMysteries: Unresolved Mysteries
PoliticalHumor: Political Humor
cringepics: cringe pics
Rainbow6: Rainbow 6
rpg: RPG
thatHappened: that Happened
classicalmusic: classical music
somethingimade: something I made
Fantasy: Fantasy
AskHistorians: Ask Historians
carporn: car porn
niceguys: nice guys
manga: manga
Health: Health
TIHI: Thanks, I hate it
ShouldIbuythisgame: Should I buy this game
analog: analog
SkincareAddiction: Skincare Addiction
iamatotalpieceofshit: I am a total piece of shit
mashups: mashups
GlobalOffensive: Global Offensive
southpark: South Park
2meirl4meirl: 2meirl4meirl
changemyview: change my view
Survival: Survival
PoliticalDiscussion: Political Discussion
DiWHY: DiWHY
AsianBeauty: Asian Beauty
AbandonedPorn: Abandoned Porn
softwaregore: software gore
ExposurePorn: Exposure Porn
RoomPorn: Room Porn
ethtrader: eth trader
cringe: cringe
Justrolledintotheshop: Just rolled into the shop
vandwellers: van dwellers
confusing_perspective: confusing perspective
meirl: me_irl
FreeEBOOKS: Free EBOOKS
MachinePorn: Machine Porn
hockey: hockey
insaneparents: insane parents
Cringetopia: Cringetopia
photocritique: photo critique
specializedtools: specialized tools
terriblefacebookmemes: terrible Facebook memes
UnethicalLifeProTips: Unethical Life Pro Tips
holdmybeer: hold my beer
PS5: PS5
TooAfraidToAsk: Too Afraid To Ask
4chan: 4chan
Shoestring: shoestring
ADHD: ADHD
LivestreamFail: Livestream Fail
Poetry: Poetry
teslamotors: Tesla Motors
maybemaybemaybe: maybe maybe maybe
privacy: privacy
self: self
AbruptChaos: Abrupt Chaos
toptalent: top talent
WhatsWrongWithYourDog: What's Wrong With Your Dog
IWantOut: I Want Out
FuckYouKaren: Fuck You Karen
fightporn: fight porn
truegaming: true gaming
digitalnomad: digital nomad
greentext: green text
snowboarding: snowboarding
homeautomation: home automation
subredditoftheday: subreddit of the day
DesignPorn: Design Porn
awfuleverything: awful everything
motorcycles: motorcycles
freefolk: free folk
CFB: CFB
iamverybadass: I am very badass
skyrim: Skyrim
wheredidthesodago: where did the soda go
skiing: skiing
SweatyPalms: Sweaty Palms
ANormalDayInRussia: A Normal Day In Russia
algotrading: algo trading
WhyWereTheyFilming: Why Were They Filming
ProRevenge: Pro Revenge
perfectlycutscreams: perfectly cut screams
powerwashingporn: power washing porn
Steam: Steam
StartledCats: Startled Cats
Twitch: Twitch
ImGoingToHellForThis: I'm Going To Hell For This
marvelmemes: Marvel Memes
Perfectfit: Perfect fit
gifsthatkeepongiving: gifs that keep on giving
wiiu: Wii U
Screenwriting: Screenwriting
Zoomies: Zoomies
Marvel: Marvel
pettyrevenge: petty revenge
Boxing: Boxing
Homebrewing: Homebrewing
anime_irl: anime_irl
oldpeoplefacebook: old people Facebook
DeepFriedMemes: Deep Fried Memes
vagabond: vagabond
Shitty_Car_Mods: Shitty Car Mods
PornhubComments: Pornhub Comments
oddlyterrifying: oddly terrifying
BoneAppleTea: Bone Apple Tea
MakeMeSuffer: Make Me Suffer
harrypotter: Harry Potter
westworld: Westworld
tumblr: Tumblr
Bossfight: Boss fight
RocketLeague: Rocket League
sadcringe: sad cringe
fakehistoryporn: fake history porn
3DS: 3DS
spacex: Space X
Instagramreality: Instagram reality
Animemes: Animemes
woooosh: woosh
modernwarfare: modern warfare
gtaonline: GTA Online
LetsNotMeet: Let's Not Meet
bicycling: bicycling
TheLastAirbender: The Last Airbender
holdmyfeedingtube: hold my feeding tube
familyguy: family guy
OopsDidntMeanTo: Oops Didn't Mean To
canada: Canada
Entrepreneur: Entrepreneur
ComedyCemetery: Comedy Cemetery
FanTheories: Fan Theories
HydroHomies: Hydro Homies
ThatsInsane: That's Insane
im14andthisisdeep: I'm 14 and this is deep
BuyItForLife: Buy It For Life
Amd: AMD
blessedimages: blessed images
TrueOffMyChest: True Off My Chest
climbing: climbing
Genshin_Impact: Genshin Impact
nostalgia: nostalgia
VALORANT: VALORANT
crappyoffbrands: crappy off brands
financialindependence: financial independence
okbuddyretard: ok buddy retard
Fishing: Fishing
reddit.com: reddit.com
UNBGBBIIVCHIDCTIICBG: UNBGBBIIVCHIDCTIICBG
IdiotsFightingThings: Idiots Fighting Things
forbiddensnacks: forbidden snacks
netflix: Netflix
psychology: psychology
fffffffuuuuuuuuuuuu: fffffffuuuuuuuuuuuu
MechanicalKeyboards: Mechanical Keyboards
suspiciouslyspecific: suspiciously specific
holdmyredbull: hold my Red Bull
cyberpunkgame: cyberpunk game
nononono: no no no
smashbros: Smash Bros
ethereum: Ethereum
beta: beta
DotA2: Dota 2
dankchristianmemes: dank Christian memes
IDontWorkHereLady: I Don't Work Here Lady
ShitPostCrusaders: Shit Post Crusaders
AbsoluteUnits: Absolute Units
DidntKnowIWantedThat: Didn't Know I Wanted That
shittyaskscience: shitty ask science
IWantToLearn: I Want To Learn
theydidthemath: they did the math
nvidia: nvidia
lotrmemes: lotr memes
evilbuildings: evil buildings
MostBeautiful: Most Beautiful
Paranormal: paranormal
reddeadredemption: red dead redemption
TikTokCringe: TikTok Cringe
copypasta: copypasta
aviation: aviation
webdev: web dev
Guitar: Guitar
gatekeeping: gatekeeping
StardewValley: Stardew Valley
discordapp: discord app
thisismylifenow: this is my life now
Wallstreetbetsnew: Wallstreetbets new
malelivingspace: male living space
thalassophobia: thalassophobia
GameDeals: Game Deals
TrollXChromosomes: Troll X Chromosomes
NoFap: No Fap
ihadastroke: I had a stroke
kpop: kpop
buildapcsales: build a pc sales
confessions: confessions
AccidentalRenaissance: Accidental Renaissance
getdisciplined: get disciplined
Python: Python
beermoney: beer money
surrealmemes: surreal memes
Fallout: Fallout
CasualUK: Casual UK
BrandNewSentence: Brand New Sentence
FellowKids: Fellow Kids
Glitch_in_the_Matrix: Glitch in the Matrix
goddesses: goddesses
imsorryjon: im sorry jon
bonehurtingjuice: bone hurting juice
youngpeopleyoutube: young people youtube
justneckbeardthings: just neckbeard things
freebies: freebies
Conservative: conservative
yesyesyesno: yes yes yes no
Justfuckmyshitup: Just fuck my shit up
dndmemes: dnd memes
selfimprovement: self improvement
AmateurRoomPorn: Amateur Room Porn
Drugs: Drugs
blunderyears: blunder years
witcher: witcher
whitepeoplegifs: white people gifs
options: options
clevercomebacks: clever comebacks
intermittentfasting: intermittent fasting
Terraria: Terraria
dating: dating
SubredditDrama: Subreddit Drama
depression: depression
Nicegirls: nice girls
SuddenlyGay: Suddenly Gay
dank_meme: dank meme
The_Donald: The Donald
dontputyourdickinthat: dont put your dick in that
dogswithjobs: dogs with jobs
OSHA: OSHA
PraiseTheCameraMan: Praise The Camera Man
NotMyJob: Not My Job
ScottishPeopleTwitter: Scottish People Twitter
ExpectationVsReality: Expectation Vs Reality
RobinHood: Robin Hood
environment: environment
AnimalTextGifs: Animal Text Gifs
AskOuija: Ask Ouija
lgbt: lgbt
startups: startups
ofcoursethatsathing: of course thats a thing
productivity: productivity
BokuNoHeroAcademia: Boku No Hero Academia
povertyfinance: poverty finance
worldbuilding: world building
Memes_Of_The_Dank: Memes Of The Dank
Autos: Autos
FloridaMan: Florida Man
agedlikemilk: aged like milk
AmongUs: Among Us
Breath_of_the_Wild: Breath of the Wild
antiMLM: anti MLM
houseplants: house plants
EngineeringPorn: Engineering Porn
asoiaf: asoiaf
holdmyjuicebox: hold my juice box
CityPorn: City Porn
lego: lego
3Dprinting: 3D printing
cosplaygirls: cosplay girls
talesfromtechsupport: tales from tech support
OnePiece: One Piece
creepyPMs: creepy PMs
MechanicAdvice: Mechanic Advice
DadReflexes: Dad Reflexes
FunnyandSad: Funny and Sad
JoeRogan: Joe Rogan
QuotesPorn: Quotes Porn
DecidingToBeBetter: Deciding To Be Better
raisedbynarcissists: raised by narcissists
mechanical_gifs: mechanical gifs
JusticePorn: Justice Porn
tooktoomuch: took too much
wholesomegifs: wholesome gifs
futurama: futurama
CrazyIdeas: Crazy Ideas
tippytaps: tippy taps
australia: australia
realestateinvesting: real estate investing
thanosdidnothingwrong: thanos did nothing wrong
ArchitecturePorn: Architecture Porn
LearnUselessTalents: Learn Useless Talents
holdmyfries: hold my fries
halo: halo
WeWantPlates: We Want Plates
NoahGetTheBoat: Noah Get The Boat
NASCAR: NASCAR
tennis: tennis
InternetStars: Internet Stars
suicidebywords: suicide by words
Naruto: Naruto
outside: outside
Piracy: Piracy
oddlyspecific: oddly specific
fantasyfootball: fantasy football
TheSilphRoad: The Silph Road
Meditation: Meditation
graphic_design: graphic design
linux: linux
notliketheothergirls: not like the other girls
AMA: AMA
IASIP: IASIP
boottoobig: boot too big
guns: guns
watchpeoplesurvive: watch people survive
elonmusk: elon musk
LeopardsAteMyFace: Leopards Ate My Face
brooklynninenine: brooklyn nine nine
bestoflegaladvice: best of legal advice
shittyrobots: shitty robots
TwoSentenceHorror: Two Sentence Horror
TalesFromRetail: Tales From Retail
business: business
LateStageCapitalism: Late Stage Capitalism
britishproblems: british problems
Coffee: Coffee
seduction: seduction
brasil: brasil
wallpapers: wallpapers
minimalism: minimalism
PenmanshipPorn: Penmanship Porn
offbeat: offbeat
ColorizedHistory: Colorized History
Minecraftbuilds: Minecraft builds
perfectloops: perfect loops
IllegalLifeProTips: Illegal Life Pro Tips
nflstreams: nfl streams
woof_irl: woof irl
combinedgifs: combined gifs
dontdeadopeninside: dont dead open inside
vinyl: vinyl
shortscarystories: short scary stories
destiny2: destiny 2
disneyvacation: disney vacation
sbubby: sbubby
shittymoviedetails: shitty movie details
gentlemanboners: gentleman boners
jailbreak: jailbreak
vegan: vegan
CODWarzone: COD Warzone
Cyberpunk: Cyberpunk
tiktokthots: tiktok thots
StrangerThings: Stranger Things
sysadmin: sys admin
ihavesex: i have sex
polandball: poland ball
france: france
geek: geek
Celebs: Celebs
calvinandhobbes: calvin and hobbes
EscapefromTarkov: Escape from Tarkov
tf2: tf2
XboxSeriesX: Xbox Series X
CatsStandingUp: Cats Standing Up
UrbanHell: Urban Hell
pussypassdenied: pussy pass denied
Moviesinthemaking: Movies in the making
jacksepticeye: jacksepticeye
StoppedWorking: Stopped Working
chemicalreactiongifs: chemical reaction gifs
PandR: P and R
curlyhair: curly hair
2007scape: 2007 scape
ABoringDystopia: A Boring Dystopia
HumansAreMetal: Humans Are Metal
RobinHoodPennyStocks: RobinHood Penny Stocks
redditgetsdrawn: reddit gets drawn
india: india
smallbusiness: small business
engrish: engrish
2busty2hide: 2 busty 2 hide
ConvenientCop: Convenient Cop
ThatLookedExpensive: That Looked Expensive
headphones: headphones
HadToHurt: Had To Hurt
help: help
Patriots: Patriots
AutoDetailing: Auto Detailing
ketorecipes: keto recipes
nbastreams: nba streams
Baking: Baking
INEEEEDIT: I need edit
gamedev: game dev
birdswitharms: birds with arms
FUCKYOUINPARTICULAR: FUCK YOU IN PARTICULAR
CallOfDuty: Call Of Duty
blackpeoplegifs: black people gifs
indianpeoplefacebook: indian people facebook
SquaredCircle: Squared Circle
comedyhomicide: comedy homicide
LSD: LSD
summonerschool: summoner school
Simulated: Simulated
AskCulinary: Ask Culinary
ThingsCutInHalfPorn: Things Cut In Half Porn
youtube: youtube
everymanshouldknow: every man should know
unitedkingdom: united kingdom
lotr: lotr
OldPhotosInRealLife: Old Photos In Real Life
economy: economy
ShingekiNoKyojin: Shingeki No Kyojin
GoCommitDie: Go Commit Die
weed: weed
Advice: Advice
Celebhub: Celeb hub
web_design: web design
TrueCrime: True Crime
NoMansSkyTheGame: No Mans Sky The Game
SCP: SCP
howtonotgiveafuck: how to not give a fuck
Catloaf: Cat loaf
CombatFootage: Combat Footage
Prematurecelebration: Premature celebration
Philippines: Philippines
MyPeopleNeedMe: My People Need Me
Brawlstars: Brawl stars
gamernews: gamer news
whatsthisplant: what's this plant
Daytrading: Day trading
btc: btc
AnimeART: Anime ART
TheDepthsBelow: The Depths Below
AteTheOnion: Ate The Onion
firstworldanarchists: first world anarchists
ZeroWaste: Zero Waste
learnpython: learn python
PersonalFinanceCanada: Personal Finance Canada
donthelpjustfilm: don't help just film
FORTnITE: FORTnITE
notinteresting: not interesting
cscareerquestions: cs career questions
Bad_Cop_No_Donut: Bad Cop No Donut
delusionalartists: delusional artists
FIFA: FIFA
playstation: playstation
pewdiepie: pewdiepie
IsItBullshit: Is It Bullshit
Pareidolia: Pareidolia
ActualPublicFreakouts: Actual Public Freakouts
TheWayWeWere: The Way We Were
ActLikeYouBelong: Act Like You Belong
antimeme: anti meme
creepypasta: creepypasta
babyelephantgifs: baby elephant gifs
TrueReddit: True Reddit
apolloapp: apollo app
AnimeSketch: Anime Sketch
4PanelCringe: 4 Panel Cringe
techsupportgore: tech support gore
Instantregret: Instant regret
SandersForPresident: Sanders For President
Warframe: Warframe
2healthbars: 2 health bars
lostredditors: lost redditors
EmpireDidNothingWrong: Empire Did Nothing Wrong
KenM: Ken M
misleadingthumbnails: misleading thumbnails
absolutelynotme_irl: absolutely not me irl
FashionReps: Fashion Reps
xxfitness: xxfitness
HongKong: Hong Kong
MonsterHunter: Monster Hunter
finance: finance
OnePunchMan: One Punch Man
PremierLeague: Premier League
CryptoMarkets: Crypto Markets
TumblrInAction: Tumblr In Action
CrackheadCraigslist: Crackhead Craigslist
h3h3productions: h3h3 productions
datascience: data science
shutupandtakemymoney: shut up and take my money
findareddit: find a reddit
Libertarian: Libertarian
badwomensanatomy: bad women's anatomy
hitmanimals: hitmanimals
corgi: corgi
Catswithjobs: Cats with jobs
ClashRoyale: Clash Royale
jobs: jobs
IdiotsNearlyDying: Idiots Nearly Dying
community: community
rimjob_steve: rim job steve
ffxiv: ffxiv
dndnext: dndnext
confidentlyincorrect: confidently incorrect
serialkillers: serial killers
college: college
GooglePixel: Google Pixel
csgo: csgo
menwritingwomen: men writing women
disney: disney
PoliticalCompassMemes: Political Compass Memes
Gamingcirclejerk: Gaming circle jerk
theocho: theocho
IRLEasterEggs: IRL Easter Eggs
TheMonkeysPaw: The Monkey's Paw
SelfAwarewolves: Self Aware wolves
classicwow: classic wow
RBI: RBI
MonsterHunterWorld: Monster Hunter World
Kanye: Kanye
DataHoarder: Data Hoarder
AppleWatch: Apple Watch
yoga: yoga
nhaa: nhaa
puns: puns
magicTCG: magic TCG
AccidentalRacism: Accidental Racism
Anxiety: Anxiety
standupshots: standup shots
succulents: succulents
dontyouknowwhoiam: don't you know who I am
Chonkers: Chonkers
architecture: architecture
booksuggestions: book suggestions
RetroFuturism: Retro Futurism
DCcomics: DC comics
simpleliving: simple living
onejob: one job
nocontextpics: no context pics
Botchedsurgeries: Botched surgeries
FortniteCompetitive: Fortnite Competitive
dogpictures: dog pictures
de: de
wikipedia: wikipedia
WatchandLearn: Watch and Learn
IllegallySmolCats: Illegally Smol Cats
thenetherlands: the netherlands
vexillology: vexillology
pathofexile: path of exile
SatoshiStreetBets: Satoshi Street Bets
Cursed_Images: Cursed Images
SequelMemes: Sequel Memes
wholesomeanimemes: wholesome animemes
civ: civ
doctorwho: doctor who
circlejerk: circle jerk
mexico: mexico
peopleofwalmart: people of walmart
MilitaryPorn: Military Porn
patientgamers: patient gamers
NotHowGirlsWork: Not How Girls Work
creepyasterisks: creepy asterisks
rupaulsdragrace: rupaul's drag race
ufc: ufc
bigtitsinbikinis: big tits in bikinis
BeforeNAfterAdoption: Before N After Adoption
beetlejuicing: beetle juicing
dashcamgifs: dash cam gifs
Breadit: Bread it
wholesomebpt: wholesome bpt
shittysuperpowers: shitty superpowers
beer: beer
edmproduction: edm production
InteriorDesign: Interior Design
LearnJapanese: Learn Japanese
jesuschristreddit: jesus christ reddit
happy: happy
olympics: olympics
DarkHumorAndMemes: Dark Humor And Memes
SmashBrosUltimate: Smash Bros Ultimate
SubredditSimulator: Subreddit Simulator
KamikazeByWords: Kamikaze By Words
NeutralPolitics: Neutral Politics
BoJackHorseman: BoJack Horseman
ItemShop: Item Shop
MakeNewFriendsHere: Make New Friends Here
AskScienceFiction: Ask Science Fiction
homelab: home lab
thesims: the sims
dbz: dbz
DMAcademy: DM Academy
darksouls3: dark souls 3
casualiama: casual iama
redneckengineering: redneck engineering
netsec: netsec
deadbydaylight: dead by daylight
PokemonSwordAndShield: Pokemon Sword And Shield
13or30: 13 or 30
IRLgirls: IRL girls
TrumpCriticizesTrump: Trump Criticizes Trump
ArtPorn: Art Porn
creepyencounters: creepy encounters
1200isplenty: 1200 is plenty
DnDBehindTheScreen: DnD Behind The Screen
rage: rage
TalesFromYourServer: Tales From Your Server
Thetruthishere: The truth is here
musictheory: music theory
PropagandaPosters: Propaganda Posters
assassinscreed: assassins creed
tea: tea
london: london
r4r: r4r
UnsentLetters: Unsent Letters
3amjokes: 3 am jokes
Doom: Doom
languagelearning: language learning
GameTheorists: Game Theorists
LosAngelesRams: Los Angeles Rams
Catswhoyell: Cats who yell
visualnovels: visual novels
cosplay: cosplay
Buddhism: Buddhism
IndoorGarden: Indoor Garden
LucidDreaming: Lucid Dreaming
StardustCrusaders: Stardust Crusaders
WallStreetbetsELITE: Wall Street bets ELITE
FantasyPL: Fantasy PL
PixelArt: Pixel Art
Stoicism: Stoicism
CODZombies: COD Zombies
outrun: outrun
totallynotrobots: totally not robots
Warhammer40k: Warhammer 40k
VaporwaveAesthetics: Vaporwave Aesthetics
bisexual: bisexual
blender: blender
EngineeringStudents: Engineering Students
StarWarsBattlefront: Star Wars Battlefront
awesome: awesome
googlehome: google home
de_IAmA: de I Am A
NBA2k: NBA 2k
raining: raining
realasians: real asians
ireland: ireland
cardano: cardano
fasting: fasting
CreditCards: Credit Cards
MangaCollectors: Manga Collectors
tech: tech
fo4: fo4
goodanimemes: good animemes
popheads: popheads
Aquariums: Aquariums
MarvelStudiosSpoilers: Marvel Studios Spoilers
BirdsArentReal: Birds Aren't Real
cookingforbeginners: cooking for beginners
needadvice: need advice
DepthHub: Depth Hub
mildlypenis: mildly penis
Embroidery: Embroidery
animememes: anime memes
youdontsurf: you don't surf
TheSimpsons: The Simpsons
theyknew: they knew
TalesFromTheFrontDesk: Tales From The Front Desk
popping: popping
LongDistance: Long Distance
knitting: knitting
ukpolitics: uk politics
Animesuggest: Anime suggest
whatcouldgoright: what could go right
holdmycatnip: hold my catnip
submechanophobia: submechanophobia
iamveryrandom: I am very random
Neverbrokeabone: Never broke a bone
shittyreactiongifs: shitty reaction gifs
Badfaketexts: Bad fake texts
golf: golf
Superbowl: Super Bowl
Handwriting: Handwriting
borderlands3: borderlands 3
nocontext: no context
whatsthisbug: what's this bug
engineering: engineering
Windows10: Windows 10
AccidentalWesAnderson: Accidental Wes Anderson
HunterXHunter: Hunter X Hunter
chess: chess
shockwaveporn: shockwave porn
TheMandalorianTV: The Mandalorian TV
conspiracytheories: conspiracy theories
RedditLaqueristas: Reddit Laqueristas
roblox: roblox
DungeonsAndDragons: Dungeons And Dragons
medicalschool: medical school
MEOW_IRL: MEOW IRL
godtiersuperpowers: god tier superpowers
AskAnAmerican: Ask An American
Colorization: Colorization
batman: batman
forwardsfromgrandma: forwards from grandma
skateboarding: skateboarding
hometheater: home theater
minipainting: mini painting
Blep: Blep
WorkOnline: Work Online
Seaofthieves: Sea of thieves
excel: excel
budgetfood: budget food
ApplyingToCollege: Applying To College
trebuchetmemes: trebuchet memes
nyc: nyc
UKPersonalFinance: UK Personal Finance
ComedyNecrophilia: Comedy Necrophilia
oculus: oculus
thedivision: the division
whowouldwin: who would win
ToiletPaperUSA: Toilet Paper USA
attackontitan: attack on titan
cordcutters: cord cutters
sewing: sewing
Ultralight: Ultralight
EDC: EDC
HighStrangeness: High Strangeness
Makeup: Makeup
nukedmemes: nuked memes
mallninjashit: mall ninja shit
ElderScrolls: Elder Scrolls
ItHadToBeBrazil: It Had To Be Brazil
minecraftsuggestions: minecraft suggestions
Hololive: Hololive
Naturewasmetal: Nature was metal
CatsAreAssholes: Cats Are Assholes
medicine: medicine
CitiesSkylines: Cities Skylines
IncelTears: Incel Tears
Foodforthought: Food for thought
Repsneakers: Rep sneakers
datingoverthirty: dating over thirty
homegym: home gym
NobodyAsked: Nobody Asked
KitchenConfidential: Kitchen Confidential
singapore: singapore
LeagueOfMemes: League Of Memes
wtfstockphotos: wtf stock photos
OTMemes: OT Memes
AskUK: Ask UK
NuclearRevenge: Nuclear Revenge
socialism: socialism
pyrocynical: pyrocynical
marketing: marketing
comedynecromancy: comedy necromancy
TheRightCantMeme: The Right Can't Meme
UFOs: UFOs
GTAV: GTAV
Psychonaut: Psychonaut
Satisfyingasfuck: Satisfying as fuck
happycowgifs: happy cow gifs
UnsolvedMysteries: Unsolved Mysteries
KeanuBeingAwesome: Keanu Being Awesome
sweden: sweden
fatlogic: fatlogic
AskAcademia: Ask Academia
photoshop: photoshop
beards: beards
acturnips: acturnips
LofiHipHop: Lofi Hip Hop
DnDGreentext: DnD Greentext
womensstreetwear: womens streetwear
forhonor: for honor
toronto: toronto
veganrecipes: vegan recipes
happycrowds: happy crowds
HumanForScale: Human For Scale
ScarySigns: Scary Signs
ifyoulikeblank: if you like blank
TattooDesigns: Tattoo Designs
AskEconomics: Ask Economics
darksouls: dark souls
gravityfalls: gravity falls
plantclinic: plant clinic
elderscrollsonline: elder scrolls online
COVID19: COVID19
GTAGE: GTAGE
ClashOfClans: Clash Of Clans
baconreader: bacon reader
FrugalFemaleFashion: Frugal Female Fashion
happycryingdads: happy crying dads
melbourne: melbourne
Tools: Tools
CryptoMoonShots: Crypto Moon Shots
absolutelynotmeirl: absolutely not meirl
restofthefuckingowl: rest of the fucking owl
ImaginaryLandscapes: Imaginary Landscapes
actuallesbians: actual lesbians
blackmirror: black mirror
gatesopencomeonin: gates open come on in
reddeadredemption2: red dead redemption 2
PrettyGirls: Pretty Girls
declutter: declutter
PuppySmiles: Puppy Smiles
toastme: toast me
LosAngeles: Los Angeles
bigboye: bigboye
binance: binance
shitposting: shitposting
vaxxhappened: vaxx happened
shrooms: shrooms
CringeAnarchy: Cringe Anarchy
gifsthatendtoosoon: gifs that end too soon
offlineTV: offline TV
megalophobia: megalophobia
shittyrainbow6: shitty rainbow 6
hardcoreaww: hardcore aww
AnimalsBeingGeniuses: Animals Being Geniuses
badeconomics: bad economics
Ghosts: Ghosts
MildlyVandalised: Mildly Vandalised
gundeals: gundeals
BadMUAs: Bad MUAs
Miniworlds: Miniworlds
manhwa: manhwa
SubwayCreatures: Subway Creatures
valheim: valheim
AnimeFunny: Anime Funny
HumanPorn: Human Porn
adventuretime: adventure time
Cartalk: Car talk
Pizza: Pizza
Military: Military
pokemontrades: pokemon trades
noisygifs: noisy gifs
watchpeopledie: watch people die
Borderlands: Borderlands
learnart: learn art
boxoffice: box office
Bundesliga: Bundesliga
streetwearstartup: streetwear startup
feedthebeast: feed the beast
gainit: gainit
intel: intel
AreTheStraightsOK: Are The Straights OK
quotes: quotes
MasterReturns: Master Returns
litecoin: litecoin
thingsforants: things for ants
ramen: ramen
vancouver: vancouver
CatTaps: Cat Taps
unixporn: unix porn
EverythingScience: Everything Science
Sims4: Sims 4
MURICA: MURICA
fakealbumcovers: fake album covers
HowToHack: How To Hack
awwwtf: awwwtf
Smite: Smite
warriors: warriors
breathinginformation: breathing information
mycology: mycology
gtaglitches: gta glitches
landscaping: landscaping
Persona5: Persona 5
medizzy: medizzy
ShitAmericansSay: Shit Americans Say
DeadBedrooms: Dead Bedrooms
italy: italy
beauty: beauty
aliens: aliens
TheBoys: The Boys
japan: japan
fo76: fo76
ImaginaryMonsters: Imaginary Monsters
gaybros: gaybros
TopMindsOfReddit: Top Minds Of Reddit
AskDocs: Ask Docs
LiverpoolFC: Liverpool FC
Ripple: Ripple
Celebswithbigtits: Celebs with big tits
lewronggeneration: le wrong generation
ich_iel: ich_iel
totalwar: total war
skyrimmods: skyrim mods
animegifs: anime gifs
webcomics: webcomics
formuladank: formula dank
WaltDisneyWorld: Walt Disney World
MensRights: Mens Rights
pointlesslygendered: pointlessly gendered
MemeTemplatesOfficial: Meme Templates Official
tattoo: tattoo
PartyParrot: Party Parrot
seriouseats: serious eats
spotify: spotify
WitchesVsPatriarchy: Witches Vs Patriarchy
EntitledBitch: Entitled Bitch
subnautica: subnautica
dogelore: dogelore
TrueFilm: True Film
catsareliquid: cats are liquid
MuseumOfReddit: Museum Of Reddit
tuckedinkitties: tucked in kitties
stevenuniverse: steven universe
texas: texas
marijuanaenthusiasts: marijuana enthusiasts
careerguidance: career guidance
PokemonGoFriends: Pokemon Go Friends
CrackWatch: Crack Watch
CrusaderKings: Crusader Kings
playrust: play rust
antiwork: anti work
newzealand: new zealand
churning: churning
Marriage: Marriage
socialanxiety: social anxiety
firstworldproblems: first world problems
Seattle: Seattle
Undertale: Undertale
reddevils: red devils
LadyBoners: Lady Boners
blackopscoldwar: black ops cold war
lastimages: last images
weightroom: weight room
technews: tech news
chromeos: chrome os
SkincareAddicts: Skincare Addicts
lakers: lakers
Dogtraining: Dog training
Markiplier: Markiplier
stopdrinking: stop drinking
mangaswap: manga swap
BreadStapledToTrees: Bread Stapled To Trees
raimimemes: raimi memes
wowthissubexists: wow this sub exists
bertstrips: bert strips
trashpandas: trash pandas
drunk: drunk
geopolitics: geopolitics
AAAAAAAAAAAAAAAAA: AAAAAAAAAAAAAAAAA
Diablo: Diablo
Mindfulness: Mindfulness
heroesofthestorm: heroes of the storm
fantasywriters: fantasy writers
toolporn: tool porn
EliteDangerous: Elite Dangerous
hardwareswap: hardware swap
cellbits: cellbits
imaginarymaps: imaginary maps
arduino: arduino
DeadorVegetable: Dead or Vegetable
labrats: lab rats
ABraThatFits: A Bra That Fits
TooMeIrlForMeIrl: Too Me Irl For Me Irl
instantbarbarians: instant barbarians
CabinPorn: Cabin Porn
fashion: fashion
jobuds: jo buds
GME: GME
RedDeadOnline: Red Dead Online
startrek: star trek
torontoraptors: toronto raptors
functionalprint: functional print
Christianity: Christianity
statistics: statistics
blop: blop
AccidentalCamouflage: Accidental Camouflage
LetsTalkMusic: Let's Talk Music
vegetarian: vegetarian
inthesoulstone: in the soul stone
coding: coding
japanpics: japan pics
BitcoinBeginners: Bitcoin Beginners
RimWorld: RimWorld
Skincare_Addiction: Skincare Addiction
MixedRaceGirls: Mixed Race Girls
Sidemen: Sidemen
StonerEngineering: Stoner Engineering
WouldYouRather: Would You Rather
GrandTheftAutoV: Grand Theft Auto V
bayarea: bay area
Needafriend: Need a friend
germany: germany
InsanePeopleQuora: Insane People Quora
EconomicHistory: Economic History
MinecraftMemes: Minecraft Memes
microgrowery: micro growery
ontario: ontario
Anticonsumption: Anti consumption
Stellaris: Stellaris
Blackops4: Black ops 4
hiphop101: hip hop 101
xbox: xbox
fullmoviesonyoutube: full movies on youtube
collapse: collapse
MUAontheCheap: MUA on the Cheap
NintendoSwitchDeals: Nintendo Switch Deals
SlyGifs: Sly Gifs
argentina: argentina
fivenightsatfreddys: five nights at freddys
AccidentalComedy: Accidental Comedy
HobbyDrama: Hobby Drama
Competitiveoverwatch: Competitive Overwatch
SuicideWatch: Suicide Watch
starcraft: starcraft
criticalrole: critical role
NHLStreams: NHL Streams
TinyHouses: Tiny Houses
teefies: teefies
FortniteLeaks: Fortnite Leaks
amv: amv
painting: painting
bjj: bjj
PS4Deals: PS4 Deals
Sneks: Sneks
Cricket: Cricket
StruggleFucking: Struggle Fucking
onions: onions
PhotoshopRequest: Photoshop Request
Thisismylifemeow: This is my life meow
WhatsWrongWithYourCat: What's Wrong With Your Cat
NeckbeardNests: Neckbeard Nests
runescape: runescape
boston: boston
HermitCraft: HermitCraft
fitmeals: fit meals
ArcherFX: Archer FX
Battlefield: Battlefield
roosterteeth: roosterteeth
wholesomegreentext: wholesome greentext
lawncare: lawn care
BeautyGuruChatter: Beauty Guru Chatter
arresteddevelopment: arrested development
SapphoAndHerFriend: Sappho And Her Friend
cosplayprops: cosplay props
FinalFantasy: Final Fantasy
CampingGear: Camping Gear
ACTrade: AC Trade
smoking: smoking
AnimeMusicVideos: Anime Music Videos
chicago: chicago
Superstonk: Superstonk
Nootropics: Nootropics
Rainmeter: Rainmeter
deepweb: deep web
titanfall: titanfall
askgaybros: ask gay bros
raidsecrets: raid secrets
fireemblem: fire emblem
techsupportmacgyver: tech support macgyver
brushybrushy: brushy brushy
RedditSessions: Reddit Sessions
hiphopvinyl: hip hop vinyl
unstirredpaint: unstirred paint
OverwatchUniversity: Overwatch University
WeatherGifs: Weather Gifs
TalesFromTheCustomer: Tales From The Customer
Hulu: Hulu
Guildwars2: Guild wars 2
introvert: introvert
TechNewsToday: Tech News Today
Hair: Hair
betterCallSaul: better Call Saul
wokekids: woke kids
powerlifting: powerlifting
curledfeetsies: curled feetsies
90DayFiance: 90 Day Fiance
MLBStreams: MLB Streams
malegrooming: male grooming
AskEurope: Ask Europe
bloodborne: bloodborne
GTAorRussia: GTA or Russia
burdurland: burdurland
ac_newhorizons: ac new horizons
Polska: Polska
occult: occult
HomeDecorating: Home Decorating
grilledcheese: grilled cheese
Turkey: Turkey
BeautifulFemales: Beautiful Females
RealLifeShinies: Real Life Shinies
anime_titties: anime titties
thanksihateit: thanks i hate it
weeaboo: weeaboo
DigitalPainting: Digital Painting
RealEstate: Real Estate
IncestPorn: Incest Porn
emulation: emulation
ShitMomGroupsSay: Shit Mom Groups Say
eatsandwiches: eat sandwiches
animenocontext: anime no context
rapbattles: rap battles
nothingeverhappens: nothing ever happens
killthecameraman: kill the cameraman
ipad: iPad
reactjs: react js
coaxedintoasnafu: coaxed into a snafu
DC_Cinematic: DC Cinematic
democrats: democrats
knives: knives
Angryupvote: Angry upvote
barkour: barkour
resumes: resumes
onebag: one bag
JordanPeterson: Jordan Peterson
prettyaltgirls: pretty alt girls
instantpot: instant pot
boomershumor: boomers humor
askwomenadvice: ask women advice
saiyanpeopletwitter: saiyan people twitter
Old_Recipes: Old Recipes
AntiJokes: Anti Jokes
cybersecurity: cyber security
Disneyland: Disneyland
Scams: Scams
JonWinsTheThrone: Jon Wins The Throne
TheRedPill: The Red Pill
TheRealJoke: The Real Joke
whatintarnation: what in tarnation
notlikeothergirls: not like other girls
TrueCrimeDiscussion: True Crime Discussion
mbti: mbti
GamersRiseUp: Gamers Rise Up
eu4: eu 4
ImaginarySliceOfLife: Imaginary Slice Of Life
Unity3D: Unity 3D
arabfunny: arab funny
gay: gay
StreetFights: Street Fights
glitch_art: glitch art
MortalKombat: Mortal Kombat
androidapps: android apps
cableporn: cable porn
HitBoxPorn: Hit Box Porn
danganronpa: danganronpa
bostonceltics: boston celtics
afkarena: afk arena
crossfit: crossfit
linguistics: linguistics
keming: keming
FullScorpion: Full Scorpion
AskElectronics: Ask Electronics
HelpMeFind: Help Me Find
Cawwsplay: Cawws play
Drumkits: Drum kits
ACQR: ACQR
scriptedasiangifs: scripted asian gifs
FancyFollicles: Fancy Follicles
BabyBumps: Baby Bumps
masseffect: mass effect
WildernessBackpacking: Wilderness Backpacking
OneSecondBeforeDisast: One Second Before Disaster
Iamactuallyverybadass: I am actually very badass
badhistory: bad history
starwarsmemes: Star Wars Memes
delusionalcraigslist: delusional craigslist
Overwatch_Memes: Overwatch Memes
feetpics: feet pics
traaaaaaannnnnnnnnns: traaaaaaannnnnnnnnns
worldcup: world cup
ARK: ARK
PetTheDamnDog: Pet The Damn Dog
TheGirlSurvivalGuide: The Girl Survival Guide
FrankOcean: Frank Ocean
trapproduction: trap production
Spiderman: Spiderman
FreeGamesOnSteam: Free Games On Steam
starcitizen: star citizen
sushi: sushi
ProperAnimalNames: Proper Animal Names
byebyejob: bye bye job
beholdthemasterrace: behold the master race
FREE: FREE
HeavySeas: Heavy Seas
castiron: cast iron
mentalhealth: mental health
gamegrumps: game grumps
TrueAskReddit: True Ask Reddit
PupliftingNews: Puplifting News
OculusQuest: Oculus Quest
bulletjournal: bullet journal
virtualreality: virtual reality
freelance: freelance
catpranks: cat pranks
hoi4: hoi 4
Romania: Romania
IndieGaming: Indie Gaming
gif: gif
MurderedByAOC: Murdered By AOC
crochet: crochet
factorio: factorio
japanlife: Japan life
osugame: osu game
GetStudying: Get Studying
ImaginaryLeviathans: Imaginary Leviathans
grandorder: grand order
hmm: hmm
behindthegifs: behind the gifs
hbo: HBO
BobsBurgers: Bob's Burgers
answers: answers
Punny: Punny
philadelphia: Philadelphia
HollowKnight: Hollow Knight
networking: networking
StupidFood: Stupid Food
DesirePath: Desire Path
electronics: electronics
witchcraft: witchcraft
MLS: MLS
place: place
Teachers: Teachers
AskEngineers: Ask Engineers
AwesomeCarMods: Awesome Car Mods
asmr: asmr
findfashion: find fashion
wincest: wincest
thegrandtour: the grand tour
motivation: motivation
FL_Studio: FL Studio
Accounting: Accounting
THE_PACK: THE PACK
JustBootThings: Just Boot Things
Watercolor: Watercolor
indie: indie
TeamfightTactics: Teamfight Tactics
Atlanta: Atlanta
slavelabour: slave labour
appletv: Apple TV
cocktails: cocktails
confidence: confidence
nhl: NHL
sanfrancisco: San Francisco
preppers: preppers
malehairadvice: male hair advice
TopGear: Top Gear
futbol: futbol
java: Java
Konosuba: Konosuba
CatsMurderingToddlers: Cats Murdering Toddlers
forhire: for hire
titanfolk: titan folk
animalsdoingstuff: animals doing stuff
projectcar: project car
creepydesign: creepy design
sydney: Sydney
FragileWhiteRedditor: Fragile White Redditor
astrology: astrology
badtattoos: bad tattoos
acne: acne
scarystories: scary stories
MTB: MTB
Austin: Austin
KingdomHearts: Kingdom Hearts
LatinaCuties: Latina Cuties
Incorgnito: Incorgnito
InclusiveOr: Inclusive Or
furry: furry
GachaLifeCringe: Gacha Life Cringe
learnmachinelearning: learn machine learning
LegalAdviceUK: Legal Advice UK
lingling40hrs: ling ling 40 hrs
PlayStationPlus: PlayStation Plus
plotholes: plot holes
amiugly: am i ugly
piano: piano
overclocking: overclocking
piercing: piercing
imveryedgy: i'm very edgy
smoobypost: smooby post
PUBG: PUBG
yugioh: yugioh
millionairemakers: millionaire makers
splatoon: splatoon
Mommit: Mommit
radiohead: Radiohead
audioengineering: audio engineering
BattlefieldV: Battlefield V
dvdcollection: dvd collection
dayz: DayZ
airpods: AirPods
ketoscience: keto science
facebookwins: facebook wins
ableton: Ableton
forza: Forza
CatSlaps: Cat Slaps
houston: Houston
smallstreetbets: small street bets
SommerRay: Sommer Ray
California: California
XRP: XRP
FreeGameFindings: Free Game Findings
MovieSuggestions: Movie Suggestions
Paladins: Paladins
FinancialPlanning: Financial Planning
China: China
Swingers: Swingers
leangains: lean gains
learnmath: learn math
WhyWomenLiveLonger: Why Women Live Longer
chelseafc: Chelsea FC
Ooer: Ooer
snapchat: Snapchat
AndroidGaming: Android Gaming
OkCupid: OkCupid
dailyprogrammer: daily programmer
FreeKarma4U: Free Karma 4U
ArtFundamentals: Art Fundamentals
espresso: espresso
bangtan: bangtan
BeautyBoxes: Beauty Boxes
woosh: woosh
flexibility: flexibility
daddit: daddit
Warthunder: War Thunder
futureporn: future porn
30PlusSkinCare: 30 Plus Skin Care
nope: nope
Dreams: Dreams
gorillaz: Gorillaz
PhonesAreBad: Phones Are Bad
15minutefood: 15 minute food
NotHowDrugsWork: Not How Drugs Work
secretsanta: secret santa
NewTubers: New Tubers
ApexOutlands: Apex Outlands
Warhammer: Warhammer
PeopleBeingJerks: People Being Jerks
wholesomejojo: wholesome jojo
linuxmasterrace: linux master race
dadswhodidnotwantpets: dads who did not want pets
Monero: Monero
battlefield_one: battlefield one
weedstocks: weed stocks
nursing: nursing
talesfromcallcenters: tales from call centers
oneplus: OnePlus
sportsbook: sportsbook
itsaunixsystem: it's a unix system
196: 196
DontFundMe: Don't Fund Me
steamdeals: steam deals
lonely: lonely
findapath: find a path
Idubbbz: iDubbbz
KDRAMA: KDRAMA
MagicArena: Magic Arena
AnimalsOnReddit: Animals On Reddit
rant: rant
eagles: eagles
sousvide: sous vide
CallOfDutyMobile: Call Of Duty Mobile
GlobalOffensiveTrade: Global Offensive Trade
spirituality: spirituality
Feminism: Feminism
bi_irl: bi irl
hmmmgifs: hmmm gifs
gaymers: gaymers
Bonsai: Bonsai
ImaginaryTechnology: Imaginary Technology
BotanicalPorn: Botanical Porn
animation: animation
Anarchism: anarchism
LatinoPeopleTwitter: Latino People Twitter
mountandblade: mountandblade
InfrastructurePorn: Infrastructure Porn
Letterkenny: Letterkenny
CrossStitch: Cross Stitch
bindingofisaac: bindingofisaac
UnexpectedThugLife: Unexpected Thug Life
pickuplines: pickuplines
Houseporn: Houseporn
CelebsBR: CelebsBR
residentevil: residentevil
Berserk: Berserk
cursedvideos: cursedvideos
strength_training: strength training
MandelaEffect: Mandela Effect
IncreasinglyVerbose: Increasingly Verbose
ar15: ar15
amibeingdetained: amibeingdetained
DMT: DMT
AdrenalinePorn: Adrenaline Porn
ProtectAndServe: Protect and Serve
femalehairadvice: female hair advice
windows: windows
YouSeeComrade: You See Comrade
Wellworn: Wellworn
Humanoidencounters: Humanoid encounters
Portland: Portland
Vaporwave: Vaporwave
Amoledbackgrounds: Amoled backgrounds
Grimdank: Grimdank
malefashion: male fashion
MineralPorn: Mineral Porn
Cheap_Meals: Cheap Meals
Flipping: Flipping
BBQ: BBQ
BitcoinMarkets: Bitcoin Markets
Jazz: Jazz
characterdrawing: character drawing
babybigcatgifs: baby big cat gifs
dark_humor: dark humor
PanPorn: Pan Porn
Denmark: Denmark
Nike: Nike
braless: braless
MrRobot: Mr Robot
tarot: tarot
Marijuana: Marijuana
SpaceXLounge: Space X Lounge
DIYUK: DIY UK
cycling: cycling
mechmarket: mech market
Frisson: Frisson
VideoEditing: Video Editing
electronic_cigarette: electronic cigarette
Forex: Forex
Catculations: Catculations
shortcuts: shortcuts
WastedGifs: Wasted Gifs
FastWorkers: Fast Workers
SkyPorn: Sky Porn
aves: aves
minecraftseeds: minecraft seeds
morbidquestions: morbid questions
LiminalSpace: Liminal Space
ProductPorn: Product Porn
funhaus: funhaus
rpghorrorstories: rpg horror stories
Kombucha: Kombucha
blackdesertonline: blackdesertonline
CosplayBoobs: Cosplay Boobs
WWE: WWE
WalmartCelebrities: Walmart Celebrities
UnnecessaryInventions: Unnecessary Inventions
DBZDokkanBattle: DBZ Dokkan Battle
MoviePosterPorn: Movie Poster Porn
Giraffesdontexist: Giraffes don't exist
Shoes: Shoes
grilling: grilling
CryptoCurrencies: Crypto Currencies
HailCorporate: Hail Corporate
GamingDetails: Gaming Details
polyamory: polyamory
AvatarMemes: Avatar Memes
orochinho: orochinho
horrorlit: horror lit
retrogaming: retro gaming
PlantedTank: Planted Tank
TheYouShow: The You Show
tommyinnit: tommy innit
paradoxplaza: paradox plaza
samsung: samsung
apexuniversity: apexuniversity
pan: pan
newjersey: new jersey
GreenBayPackers: Green Bay Packers
thelastofus: thelastofus
ZenHabits: Zen Habits
AquaticAsFuck: Aquatic As Fuck
DesignMyRoom: Design My Room
Davie504: Davie504
trailerparkboys: trailerparkboys
thecatdimension: thecatdimension
footballmanagergames: football manager games
Animewallpaper: Anime wallpaper
lostgeneration: lost generation
premed: premed
Nails: Nails
exmormon: exmormon
SupermodelCats: Supermodel Cats
TargetedShirts: Targeted Shirts
AusFinance: Aus Finance
asianpeoplegifs: asianpeoplegifs
leanfire: leanfire
Rabbits: Rabbits
TankPorn: Tank Porn
52book: 52 book
cinematography: cinematography
awwnime: awwnime
ketogains: ketogains
bigdickproblems: bigdickproblems
UnusAnnus: Unus Annus
moderatepolitics: moderate politics
modnews: modnews
xqcow: xqcow
awfuleyebrows: awful eyebrows
Layer: Layer
AstralProjection: Astral Projection
fountainpens: fountain pens
sportsarefun: sports are fun
communism: communism
indie_rock: indie rock
subaru: subaru
thanksimcured: thanks I'm cured
TwoRedditorsOneCup: Two Redditors One Cup
AskMenOver30: Ask Men Over 30
PalaceClothing: Palace Clothing
airsoft: airsoft
pelotoncycle: pelotoncycle
CallMeCarson: Call Me Carson
HaircareScience: Haircare Science
Gunners: Gunners
Dogberg: Dogberg
depression_memes: depression_memes
DreamWasTaken: Dream Was Taken
KarmaCourt: Karma Court
Models: Models
streetphotography: street photography
PunPatrol: Pun Patrol
memesITA: memesITA
ObscureMedia: Obscure Media
German: German
typography: typography
ExpandDong: Expand Dong
xboxinsiders: xbox insiders
Welding: Welding
orslokx: orslokx
pornfree: porn free
synthesizers: synthesizers
Lovecraft: Lovecraft
devops: devops
ItsAmateurHour: Its Amateur Hour
dndmaps: dnd maps
Denver: Denver
distantsocializing: distant socializing
football: football
GradSchool: Grad School
DecreasinglyVerbose: Decreasingly Verbose
SiegeAcademy: Siege Academy
BadDesigns: Bad Designs
HIMYM: HIMYM
soccerstreams: soccer streams
playboicarti: playboicarti
korea: korea
Calgary: Calgary
ImaginaryCharacters: Imaginary Characters
Tendies: Tendies
diablo3: diablo3
node: node
seinfeld: seinfeld
GlitchInTheMatrix: Glitch In The Matrix
metalgearsolid: metalgearsolid
buildapcforme: buildapcforme
ClassyPornstars: Classy Pornstars
iiiiiiitttttttttttt: iiiiiiitttttttttttt
FallGuysGame: Fall Guys Game
guitarlessons: guitar lessons
Michigan: Michigan
wicked_edge: wicked_edge
CFBStreams: CFB Streams
skamtebord: skamtebord
Bushcraft: Bushcraft
Assistance: Assistance
BMW: BMW
BDSMAdvice: BDSM Advice
speedrun: speedrun
makinghiphop: makinghiphop
matureplants: mature plants
MinecraftCommands: Minecraft Commands
BoringCompany: Boring Company
evangelion: evangelion
sixers: sixers
awardtravel: award travel
DesignerReps: Designer Reps
computerscience: computer science
Incest_Gifs: Incest Gifs
AskPhotography: Ask Photography
blackcats: black cats
DDLC: DDLC
GirlsMirin: Girls Mirin
PleX: PleX
FullmetalAlchemist: Fullmetal Alchemist
legendofkorra: legendofkorra
footballhighlights: football highlights
AlienBlue: Alien Blue
DarkJokeCentral: Dark Joke Central
HadesTheGame: Hades The Game
HomeNetworking: Home Networking
awakened: awakened
deals: deals
humblebrag: humblebrag
FinancialCareers: Financial Careers
selfie: selfie
CongratsLikeImFive: Congrats Like Im Five
MedievalCats: Medieval Cats
Brogress: Brogress
screenshots: screenshots
MomForAMinute: Mom For A Minute
Birbs: Birbs
FitAndNatural: Fit And Natural
classic4chan: classic4chan
2meirl42meirl4meirl: 2meirl42meirl4meirl
PiratedGames: Pirated Games
GoodFakeTexts: Good Fake Texts
Missing411: Missing 411
cpp: cpp
Sekiro: Sekiro
Austria: Austria
Dallas: Dallas
modelmakers: modelmakers
miniminter: miniminter
TheGoodPlace: The Good Place
TIGHTPUSSY: TIGHTPUSSY
Sat: Sat
Imposter: Imposter
makeupexchange: makeup exchange
meatcrayon: meatcrayon
weddingshaming: wedding shaming
linux_gaming: linux gaming
PlantBasedDiet: Plant Based Diet
Illustration: Illustration
DankMemesFromSite19: Dank Memes From Site 19
Bottomless_Vixens: Bottomless Vixens
Instagram: Instagram
FondantHate: Fondant Hate
egg_irl: egg irl
WiggleButts: Wiggle Butts
Duklock: Duklock
leaves: leaves
logodesign: logo design
halloween: halloween
sarah_xxx: sarah_xxx
budgetcooking: budget cooking
bouldering: bouldering
MouseReview: Mouse Review
RocketLeagueExchange: Rocket League Exchange
DrawMyTattoo: Draw My Tattoo
Supplements: Supplements
dankvideos: dank videos
playark: playark
CanadianInvestor: Canadian Investor
bourbon: bourbon
GunPorn: Gun Porn
religiousfruitcake: religious fruitcake
entitledparentsmemes: entitled parents memes
simracing: sim racing
army: army
Stellar: Stellar
whiskey: whiskey
archlinux: archlinux
linuxquestions: linuxquestions
TheBullWins: The Bull Wins
haikyuu: haikyuu
gamingpc: gaming pc
HFY: HFY
EntitledPeople: Entitled People
askphilosophy: ask philosophy
Warzone: Warzone
spicy: spicy
Rateme: Rate me
UnearthedArcana: Unearthed Arcana
GarlicBreadMemes: Garlic Bread Memes
Colorado: Colorado
treedibles: treedibles
uberdrivers: uber drivers
TheoryOfReddit: Theory Of Reddit
longboarding: longboarding
whatsthisbird: what's this bird
Psychic: Psychic
privacytoolsIO: privacy tools IO
StoriesAboutKevin: Stories About Kevin
Bass: Bass
WANDAVISION: WANDAVISION
DarkSouls2: Dark Souls 2
desabafos: desabafos
PUBGMobile: PUBG Mobile
StarWarsLeaks: Star Wars Leaks
SeattleWA: Seattle WA
bitchimabus: bitch I'm a bus
emojipasta: emoji pasta
LightNovels: Light Novels
5050: 5050
Ubuntu: Ubuntu
swedishproblems: swedish problems
LawSchool: Law School
DarkNetMarkets: Dark Net Markets
etymology: etymology
crypto: crypto
winterporn: winter porn
lawofattraction: law of attraction
WeightLossAdvice: Weight Loss Advice
AnimalCrossingNewHor: Animal Crossing New Hor
coloringcorruptions: coloring corruptions
FireEmblemHeroes: Fire Emblem Heroes
puppy101: puppy 101
AfterEffects: After Effects
tombstoning: tombstoning
Supernatural: Supernatural
MCPE: MCPE
SafeMoon: Safe Moon
me_irlgbt: me irlgbt
androiddev: android dev
linuxadmin: linux admin
sploot: sploot
DemEyesDoe: Dem Eyes Doe
GTA: GTA
SpidermanPS4: Spiderman PS4
Animalsthatlovemagic: Animals that love magic
wimmelbilder: wimmelbilder
antiassholedesign: anti asshole design
MacOS: Mac OS
opendirectories: open directories
ManufacturingPorn: Manufacturing Porn
beyondthebump: beyond the bump
secretcompartments: secret compartments
Leathercraft: Leather craft
dyinglight: dying light
sandiego: san diego
SPACs: SPACs
amazon: amazon
linux4noobs: linux 4 noobs
Bumble: Bumble
PowerShell: Power Shell
trippy: trippy
fashionporn: fashion porn
BritishSuccess: British Success
Pikabu: Pikabu
ImaginaryMindscapes: Imaginary Mindscapes
Keep_Track: Keep Track
csharp: c sharp
MensLib: Mens Lib
poker: poker
socialmedia: social media
StarVStheForcesofEvil: Star VS the Forces of Evil
svenskpolitik: svensk politik
chaoticgood: chaotic good
Borderlands2: Borderlands 2
TOR: TOR
tylerthecreator: tyler the creator
starbucks: starbucks
NorthCarolina: North Carolina
agedlikewine: aged like wine
TheExpanse: The Expanse
EatCheapAndVegan: Eat Cheap And Vegan
PhotoshopTutorials: Photoshop Tutorials
MetalMemes: Metal Memes
Infographics: Infographics
fantasybball: fantasy bball
ladyladyboners: lady lady boners
MMORPG: MMORPG
funkopop: funkopop
Calligraphy: Calligraphy
EntrepreneurRideAlong: Entrepreneur Ride Along
tipofmyjoystick: tip of my joystick
family: family
Re_Zero: Re Zero
physicsgifs: physics gifs
pitbulls: pit bulls
swtor: swtor
BeansInThings: Beans In Things
programminghorror: programming horror
ArianaGrande: Ariana Grande
Suomi: Suomi
sequence: sequence
TalesFromThePizzaGuy: Tales From The Pizza Guy
HalfLife: Half Life
AmericanHorrorStory: American Horror Story
aws: aws
Vive: Vive
Republican: Republican
fatFIRE: fat FIRE
portugal: portugal
ImaginaryBehemoths: Imaginary Behemoths
asktransgender: ask transgender
ENLIGHTENEDCENTRISM: ENLIGHTENED CENTRISM
ghibli: ghibli
VolleyballGirls: Volleyball Girls
gamecollecting: game collecting
Fuckthealtright: Fuck the alt right
CatsWithDogs: Cats With Dogs
WikiLeaks: Wiki Leaks
mlem: mlem
gay_irl: gay irl
WarshipPorn: Warship Porn
PSVR: PSVR
chile: chile
virginvschad: virgin vs chad
GodofWar: God of War
TaylorSwift: Taylor Swift
LodedDiper: Loded Diper
lfg: lfg
ITCareerQuestions: IT Career Questions
darknet: darknet
100yearsago: 100 years ago
The_Dennis: The Dennis
Stepdadreflexes: Stepdad reflexes
Pets: Pets
StandUpComedy: Stand Up Comedy
Witcher3: Witcher 3
travisscott: travis scott
dontflinch: dont flinch
BlackClover: Black Clover
myfavoritemurder: my favorite murder
PornoMemes: Porno Memes
progun: pro gun
vaporents: vapor ents
ForeverAloneDating: Forever Alone Dating
kendalljenner: kendall jenner
internetparents: internet parents
SampleSize: Sample Size
2b2t: 2b2t
DivinityOriginalSin: Divinity Original Sin
Permaculture: Permaculture
WTFgaragesale: WTF garage sale
sololeveling: solo leveling
Misogynyfetish: Misogyny fetish
bestofnetflix: best of netflix
SEO: SEO
moviescirclejerk: movies circle jerk
riddles: riddles
Firearms: Firearms
catpics: cat pics
SecurityAnalysis: Security Analysis
ios: ios
howyoudoin: how you doin
AnthemTheGame: Anthem The Game
survivinginfidelity: surviving infidelity
security: security
DarK: DarK
FamosasGostosas: Famosas Gostosas
thebachelor: the bachelor
ImaginaryWesteros: Imaginary Westeros
APStudents: AP Students
gaybrosgonemild: gay bros gone mild
washingtondc: washington dc
norge: norge
onguardforthee: on guard for thee
learnjavascript: learn javascript
birding: birding
DankLeft: Dank Left
Crunchyroll: Crunchyroll
naturalbodybuilding: natural body building
fictionalpsychology: fictional psychology
whereintheworld: where in the world
suddenlysexoffender: suddenly sex offender
MilitaryGfys: MilitaryGfys
RDR2: RDR2
redditrequest: reddit request
ClimbingPorn: Climbing Porn
MushroomGrowers: Mushroom Growers
PokemonGoSpoofing: Pokemon Go Spoofing
love: love
fuckmeat: fuck meat
tolkienfans: tolkien fans
jesuschristouija: jesus christ ouija
flying: flying
BeginnerWoodWorking: Beginner Wood Working
fnv: fnv
DeathStranding: Death Stranding
Spanish: Spanish
Paleo: Paleo
trans: trans
GalGadot: Gal Gadot
reverseanimalrescue: reverse animal rescue
alexandradaddario: alexandra daddario
The10thDentist: The10th Dentist
eFreebies: e Freebies
TheOnion: The Onion
RandomKindness: Random Kindness
plants: plants
Ghoststories: Ghost stories
razer: razer
MagicEye: Magic Eye
redditmobile: reddit mobile
Alternativerock: Alternative rock
Scotland: Scotland
proplifting: prop lifting
malaysia: malaysia
JonTron: Jon Tron
recruitinghell: recruiting hell
sffpc: sffpc
EmilyRatajkowski: Emily Ratajkowski
spiderbro: spider bro
bearsdoinghumanthings: bears doing human things
murdermittens: murder mittens
2020PoliceBrutality: 2020 Police Brutality
cowboys: cowboys
rockets: rockets
cowboybebop: cowboy bebop
Hue: Hue
youtubers: youtubers
muglife: mug life
BackYardChickens: Back Yard Chickens
lockpicking: lock picking
whiteknighting: white knighting
videography: videography
law: law
Random_Acts_Of_Amazon: Random Acts Of Amazon
The_Mueller: The Mueller
battlemaps: battle maps
LWIAY: LWIAY
SexyWomanOfTheDay: Sexy Woman Of The Day
SkincareAddictionUK: Skincare Addiction UK
AnimalPorn: Animal Porn
androidthemes: android themes
MacroPorn: Macro Porn
russia: russia
donaldglover: donald glover
WatchRedditDie: Watch Reddit Die
AwesomeOffBrands: Awesome Off Brands
KimetsuNoYaiba: Kimetsu No Yaiba
introverts: introverts
IndiaSpeaks: India Speaks
chicagobulls: chicago bulls
reddeadmysteries: red dead mysteries
wholesomeyuri: wholesome yuri
GirlsInFlarePants: Girls In Flare Pants
KneadyCats: Kneady Cats
LinusTechTips: Linus Tech Tips
fifthworldproblems: fifth world problems
AOC: AOC
survivor: survivor
Floof: Floof
Eve: Eve
dankruto: dank ruto
punk: punk
AdPorn: Ad Porn
FlashTV: Flash TV
GameOfThronesMemes: Game Of Thrones Memes
dragonballfighterz: dragon ball fighterz
Mirrorsforsale: Mirrors for sale
90dayfianceuncensored: 90 day fiance uncensored
shitpost: shitpost
FemaleDatingStrategy: Female Dating Strategy
QAnonCasualties: QAnon Casualties
barstoolsports: bar stool sports
justdependathings: just dependa things
sciencefiction: science fiction
AirForce: Air Force
ecommerce: e commerce
ForeverAlone: Forever Alone
dontstarve: dont starve
BollywoodRealism: Bollywood Realism
lolgrindr: lol grindr
ilikthebred: ilik the bred
microdosing: micro dosing
MegNutt: Meg Nutt
Mcat: Mcat
brasilivre: brasil livre
goldenretrievers: golden retrievers
crossdressing: cross dressing
Kikpals: Kik pals
nosurf: no surf
Eminem: Eminem
supremeclothing: supreme clothing
islam: islam
Vechain: Vechain
LegendsOfRuneterra: Legends Of Runeterra
PutAnEggOnIt: Put An Egg On It
AirBnB: Air BnB
OurPresident: Our President
redditsings: reddit sings
RandomActsOfGaming: Random Acts Of Gaming
gamedesign: game design
toddlers: toddlers
billieeilish: billie eilish
Dashcam: Dashcam
consulting: consulting
MDMA: MDMA
dividends: dividends
DivorcedBirds: Divorced Birds
ImaginaryCityscapes: Imaginary Cityscapes
BreadTube: Bread Tube
catfaceplant: cat face plant
amex: amex
oilpainting: oil painting
funnysigns: funny signs
kurzgesagt: kurzgesagt
Youtooz: Youtooz
wine: wine
skeptic: skeptic
minnesota: minnesota
JavDownloadCenter: Jav Download Center
yiffinhell: yiffin hell
HomeworkHelp: Homework Help
sneakermarket: sneaker market
goodyearwelt: good year welt
RWBY: RWBY
omad: omad
BestOfReports: Best Of Reports
brisbane: brisbane
OnlyFansStars: Only Fans Stars
ImaginaryArchitecture: Imaginary Architecture
BreakUps: Break Ups
TVDetails: TV Details
PourPainting: Pour Painting
torrents: torrents
electricians: electricians
fatpeoplehate: fat people hate
wwiipics: wwii pics
dragonage: dragon age
Ohio: Ohio
rugbyunion: rugby union
comicbookmovies: comic book movies
facingtheirparenting: facing their parenting
Amish: Amish
amcstock: amc stock
weddingplanning: wedding planning
bujo: bujo
Whatisthis: What is this
darkestdungeon: darkest dungeon
Repaintings: Repaintings
titlegore: title gore
TrueCrimePodcasts: True Crime Podcasts
EDH: EDH
SaimanSays: Saiman Says
TurkeyJerky: Turkey Jerky
fatestaynight: fate stay night
ShitRedditSays: Shit Reddit Says
discgolf: disc golf
JojosBizarreMemePage: Jojos Bizarre Meme Page
overlord: overlord
FreezingFuckingCold: Freezing Fucking Cold
JUSTNOFAMILY: JUST NO FAMILY
Dachshund: Dachshund
masterhacker: master hacker
MadeMeCry: Made Me Cry
wholesome: wholesome
steelers: steelers
sales: sales
steak: steak
penpals: pen pals
belgium: belgium
fuckHOA: fuck HOA
FoundPaper: Found Paper
horizon: horizon
CanadaPolitics: Canada Politics
ainbow: ainbow
Hunting: Hunting
kittens: kittens
femboy: femboy
DeepFuckingValue: Deep Fucking Value
Xiaomi: Xiaomi
Amouranth: Amouranth
Switch: Switch
BadMensAnatomy: Bad Mens Anatomy
Watchexchange: Watch exchange
WrestleWithThePlot: Wrestle With The Plot
uselessredcircle: useless red circle
learntodraw: learn to draw
randonauts: randonauts
KendrickLamar: Kendrick Lamar
DragonballLegends: Dragonball Legends
golang: go lang
drunkencookery: drunken cookery
TheFappening: The Fappening
starwarsspeculation: star wars speculation
passive_income: passive income
MGTOW: MGTOW
farcry: far cry
AskNetsec: Ask Netsec
LGBTeens: LGBT teens
Megumin: Megumin
BigBrother: Big Brother
Genshin_Memepact: Genshin Memepact
pagan: pagan
snapchatgw: snapchat gw
1500isplenty: 1500 is plenty
AppHookup: App Hookup
sciences: sciences
cosplayers: cosplayers
mildlysatisfying: mildly satisfying
homeowners: homeowners
CoDCompetitive: CoD Competitive
swordartonline: sword art online
legostarwars: lego star wars
namenerds: name nerds
EmmaWatson: Emma Watson
FreeCompliments: Free Compliments
RATS: RATS
printSF: print SF
legaladviceofftopic: legal advice off topic
Hacking_Tutorials: Hacking Tutorials
CatsISUOTTATFO: Cats IS U O T T A T F O
Scotch: Scotch
showerbeer: shower beer
furry_irl: furry_irl
evenwithcontext: even with context
DemocraticSocialism: Democratic Socialism
weeabootales: weeaboo tales
SWARJE: SWARJE
GetEmployed: Get Employed
ghostoftsushima: ghost of tsushima
LesbianActually: Lesbian Actually
DestinyFashion: Destiny Fashion
chloe: chloe
COMPLETEANARCHY: COMPLETE ANARCHY
catbellies: cat bellies
jellybeantoes: jellybean toes
CorporateFacepalm: Corporate Facepalm
Anarcho_Capitalism: Anarcho Capitalism
FreckledGirls: Freckled Girls
robotics: robotics
ROBLOXmemes: ROBLOX memes
trackers: trackers
Sourdough: Sourdough
GamingLeaksAndRumours: Gaming Leaks And Rumours
redditmoment: reddit moment
AlisonBrie: Alison Brie
Demotivational: Demotivational
TalesFromThePharmacy: Tales From The Pharmacy
musicproduction: music production
tiltshift: tilt shift
Pennsylvania: Pennsylvania
HaveWeMet: Have We Met
slammywhammies: slammy whammies
konmari: konmari
MiniLadd: Mini Ladd
StonerPhilosophy: Stoner Philosophy
iosgaming: iOS gaming
darkmemes: dark memes
DessertPorn: Dessert Porn
GirlGamers: Girl Gamers
pic: pic
MeanJokes: Mean Jokes
hackintosh: hackintosh
foxes: foxes
NewSkaters: New Skaters
audiobooks: audio books
49ers: 49ers
guitarpedals: guitar pedals
SpeedOfLobsters: Speed Of Lobsters
victoriajustice: victoria justice 
ParlerWatch: Parler Watch
Gunpla: Gunpla
UmbrellaAcademy: Umbrella Academy
cannabis: cannabis
xkcd: xkcd
postprocessing: post processing
BudgetAudiophile: Budget Audiophile
datasets: datasets
ottawa: ottawa
dreamsmp: dreamsmp
FanFiction: Fan Fiction
Surface: Surface
DestinyLore: Destiny Lore
ConanExiles: Conan Exiles
Avengers: Avengers
CoronavirusUS: Coronavirus US
mathmemes: math memes
doodles: doodles
JustUnsubbed: Just Unsubbed
InterdimensionalCable: Interdimensional Cable
Technoblade: Technoblade
artificial: artificial
michaelbaygifs: michael bay gifs
funnyvideos: funny videos
Monitors: Monitors
195: 195
Stormlight_Archive: Stormlight Archive
knifeclub: knife club
opensource: open source
TILI: TILI
veganfitness: vegan fitness
casualChildAbuse: casual Child Abuse
ShittyAnimalFacts: Shitty Animal Facts
falloutlore: fallout lore
shield: shield
fatpeoplestories: fat people stories
liluzivert: lil uzi vert
AzureLane: Azure Lane
AbusePorn2: Abuse Porn 2
AITA: AITA
Offensivejokes: Offensive jokes
SocialEngineering: Social Engineering
fastfood: fast food
ShitLiberalsSay: Shit Liberals Say
dangerousdesign: dangerous design
unexpectedoffice: unexpected office
notdisneyvacation: not disney vacation
drums: drums
CrewsCrew: Crews Crew
SatisfactoryGame: Satisfactory Game
ExtremeCarCrashes: Extreme Car Crashes
loadingicon: loading icon
StuffOnCats: Stuff On Cats
grandpajoehate: grandpa joe hate
iWallpaper: i Wallpaper
highdeas: high ideas
ThatPeelingFeeling: That Peeling Feeling
Mavericks: Mavericks
onetruegod: one true god
JDM: JDM
PERSoNA: PERSoNA
PHP: PHP
rust: rust
Frugal_Jerk: Frugal Jerk
EmKay: Em Kay
Heavymind: Heavy Mind
liberalgunowners: liberal gun owners
deliciouscompliance: delicious compliance
HeadphoneAdvice: Headphone Advice
fuckthesepeople: fuck these people
rap: rap
AnarchyChess: Anarchy Chess
French: French
OrganicGardening: Organic Gardening
infp: infp
twentyonepilots: twenty one pilots
oilpen: oil pen
Wordpress: Wordpress
Trumpgret: Trumpgret
WhatIsThisPainting: What Is This Painting
adhdmeme: adhd meme
Madden: Madden
flightsim: flight sim
repurposedbuildings: repurposed buildings
gachagaming: gacha gaming
ScarlettJohansson: Scarlett Johansson
equelMemes: equel Memes
untrustworthypoptarts: untrustworthy poptarts
PetTheDamnCat: Pet The Damn Cat
Youniqueamua: Youniqueamua
DrunkOrAKid: Drunk Or A Kid
Frontend: Frontend
IDOWORKHERELADY: IDOWORKHERELADY
theouterworlds: the outer worlds
newreddits: new reddits
Vaping: Vaping
WeirdWheels: Weird Wheels
KarmaConspiracy: Karma Conspiracy
sporetraders: spore traders
stephenking: stephen king
bettafish: betta fish
femalelivingspace: female living space
NotKenM: Not Ken M
kindle: kindle
spongebob: spongebob
communism101: communism 101
ChapoTrapHouse: Chapo Trap House
fragrance: fragrance
ToolBand: Tool Band
NewProductPorn: New Product Porn
leafs: leafs
catpictures: cat pictures
montreal: montreal
CICO: CICO
gamingsuggestions: gaming suggestions
BigCatGifs: Big Cat Gifs
software: software
firefox: firefox
Kaguya_sama: Kaguya sama
JuJutsuKaisen: Ju Jutsu Kaisen
iOSBeta: iOS Beta
PresidentialRaceMemes: Presidential Race Memes
KingOfTheHill: King Of The Hill
JRPG: JRPG
discord_irl: discord irl
assholetax: asshole tax
MeetPeople: Meet People
poland: poland
Im15AndThisIsYeet: Im 15 And This Is Yeet
IsTodayFridayThe13th: Is Today Friday The 13th
TeensNSFW: Teens NSFW
WordAvalanches: Word Avalanches
bipolar: bipolar
SnapLenses: Snap Lenses
beatles: beatles
DigitalArt: Digital Art
MusicForConcentration: Music For Concentration
productgif: product gif
montageparodies: montage parodies
FairytaleasFuck: Fairytale as Fuck
Blacksmith: Blacksmith
trap: trap
overlanding: overlanding
Metalcore: Metalcore
battlefield_4: battlefield 4
mlb: mlb
CreepyWikipedia: Creepy Wikipedia
LowSodiumCyberpunk: Low Sodium Cyberpunk
StreetFighter: Street Fighter
RepLadies: Rep Ladies
FifaCareers: Fifa Careers
orangetheory: orangetheory
Delightfullychubby: Delightfully chubby
ShinyPokemon: Shiny Pokemon
3d6: 3d6
fixit: fix it
AyyMD: Ayy MD
Seahawks: Seahawks
brockhampton: brockhampton
foraging: foraging
BPD: BPD
DarlingInTheFranxx: Darling In The Franxx
GODZILLA: GODZILLA
CatsOnKeyboards: Cats On Keyboards
XXXTENTACION: XXXTENTACION
wasletztepreis: wasletztepreis
docker: docker
snakes: snakes
ModelsGoneMild: Models Gone Mild
SoundsLikeMusic: Sounds Like Music
tonightsdinner: tonight's dinner
GoNets: Go Nets
BitLifeApp: Bit Life App
vim: vim
Iota: Iota
redditsync: reddit sync
Naturalhair: Natural hair
CGPGrey: CGP Grey
nbadiscussion: NBA discussion
Lost_Architecture: Lost Architecture
lucifer: lucifer
Sherlock: Sherlock
selfhelp: self help
microsoft: microsoft
iphonewallpapers: iphone wallpapers
thebutton: the button
Political_Revolution: Political Revolution
toosoon: too soon
40kLore: 40k Lore
CHIBears: CHI Bears
Weird: Weird
TrashTaste: Trash Taste
education: education
arknights: arknights
ik_ihe: ik_ihe
transtimelines: trans timelines
urbandesign: urban design
animepiracy: anime piracy
phoenix: phoenix
streeteats: street eats
Yogscast: Yogscast
VerifiedFeet: Verified Feet
minnesotavikings: minnesota vikings
florida: florida
Zerkaa: Zerkaa
badcode: bad code
LilGrabbies: Lil Grabbies
nier: nier
AvatarPorn: Avatar Porn
advertising: advertising
bizarrebuildings: bizarre buildings
CompetitiveWoW: Competitive WoW
obs: obs
firefly: firefly
uncensorednews: uncensored news
MkeBucks: Mke Bucks
araragi: araragi
BravoRealHousewives: Bravo Real Housewives
bangalore: bangalore
amihot: am i hot
Oxygennotincluded: Oxygen not included
RetroPie: RetroPie
tax: tax
Drama: Drama
MemePiece: Meme Piece
GhanaSaysGoodbye: Ghana Says Goodbye
Brawlhalla: Brawlhalla
wildlifephotography: wildlife photography
Boruto: Boruto
SympatheticMonsters: Sympathetic Monsters
russian: russian
RepTime: Rep Time
digital_marketing: digital marketing
bleach: bleach
rpg_gamers: RPG gamers
C25K: C25K
oneliners: one liners
Costco: Costco
bookporn: book porn
bingbongtheorem: bing bong theorem
trailrunning: trail running
NMSCoordinateExchange: NMS Coordinate Exchange
NPR: NPR
EnterTheGungeon: Enter The Gungeon
ntbdbiwdfta: ntbdbiwdfta
TopSecretRecipes: Top Secret Recipes
beerporn: beer porn
botw: botw
ak47: ak 47
Etsy: Etsy
UnexpectedlyWholesome: Unexpectedly Wholesome
UnexpectedJoJo: Unexpected JoJo
YAlit: YA lit
Jeep: Jeep
intresseklubben: intresseklubben
Awww: Awww
btd6: btd6
vexillologycirclejerk: vexillology circle jerk
gopro: gopro
CapitolConsequences: Capitol Consequences
FalloutMods: Fallout Mods
BlackPink: Black Pink
BanVideoGames: Ban Video Games
ForwardsFromKlandma: Forwards From Klandma
ebonyhomemade: ebony homemade
walmart: walmart
Paintings: Paintings
CCW: CCW
KimKardashianPics: Kim Kardashian Pics
NYKnicks: NY Knicks
chairsunderwater: chairs underwater
orangecounty: orange county
FullShrimp: Full Shrimp
southafrica: south africa
Tiresaretheenemy: Tires are the enemy
esist: esist
woweconomy: WoW economy
energy_work: energy work
DumpsterDiving: Dumpster Diving
Freefood: Free food
ShokugekiNoSoma: Shokugeki No Soma
transgender: transgender
outriders: outriders
KotakuInAction: Kotaku In Action
twinpeaks: twin peaks
INTP: INTP
teslore: tes lore
WhatShouldICook: What Should I Cook
altcoin: altcoin
castles: castles
fantasybaseball: fantasy baseball
dubstep: dubstep
googleplaydeals: google play deals
NFA: NFA
iNoobChannel: iNoob Channel
ender3: ender 3
Idiotswithguns: Idiots with guns
libertarianmeme: libertarian meme
MAAU: MAAU
Tekken: Tekken
Scrubs: Scrubs
shorthairedhotties: short haired hotties
learnspanish: learn spanish
iOSthemes: iOS themes
tall: tall
MLA_Official: MLA Official
parrots: parrots
LudwigAhgren: Ludwig Ahgren
YanetGarcia: Yanet Garcia
sustainability: sustainability
MicroPorn: Micro Porn
ForzaHorizon: Forza Horizon
khajiithaswares: khajiit has wares
CBD: CBD
AlternateAngles: Alternate Angles
tacticalgear: tactical gear
tf2shitposterclub: tf2 shitposter club
AFL: AFL
TokyoGhoul: Tokyo Ghoul
gifextra: gif extra
WatchDogsWoofInside: Watch Dogs Woof Inside
shopify: shopify
CatGifs: Cat Gifs
Roms: Roms
flashlight: flashlight
EtherMining: Ether Mining
selfhosted: self hosted
oblivion: oblivion
replications: replications
homeassistant: home assistant
TheCatTrapIsWorking: The Cat Trap Is Working
videogamedunkey: video game dunkey
stopsmoking: stop smoking
arizona: arizona
SquarePosting: Square Posting
PlayItAgainSam: Play It Again Sam
DuelLinks: Duel Links
interiordecorating: interior decorating
NameThatSong: Name That Song
SpotifyPlaylists: Spotify Playlists
VeganFoodPorn: Vegan Food Porn
CoinBase: Coin Base
CougarsAndCubs: Cougars And Cubs
whatsthatbook: what's that book
PeakyBlinders: Peaky Blinders
friendsafari: friend safari
pinkfloyd: pink floyd
FractalPorn: Fractal Porn
shittykickstarters: shitty kickstarters
Bioshock: Bioshock
WhatsInThisThing: What's In This Thing
VanLife: Van Life
facts: facts
AskVet: Ask Vet
Hiphopcirclejerk: hip hop circle jerk
NotTimAndEric: Not Tim And Eric
opiates: opiates
dfsports: DFSports
Dinosaurs: Dinosaurs
whatcarshouldIbuy: what car should I buy
shittydarksouls: shitty dark souls
mangadeals: manga deals
duolingo: duolingo
ape: ape
graphicnovels: graphic novels
letsplay: let's play
deathgrips: death grips
GiftofGames: Gift of Games
UsernameChecksOut: Username Checks Out
MxRMods: MxR Mods
UnexpectedMulaney: Unexpected Mulaney
macbookpro: macbook pro
carbage: carbage
PS3: PS3
ListOfSubreddits: List Of Subreddits
ynab: ynab
unexpectedjihad: unexpected jihad
ClashOfClansRecruit: Clash Of Clans Recruit
ImaginaryHorrors: Imaginary Horrors
thinkpad: thinkpad
BokuNoMetaAcademia: Boku No Meta Academia
BirdsBeingDicks: Birds Being Dicks
Edmonton: Edmonton
dankgentina: dank gentina
cigars: cigars
unrealengine: unreal engine
AdvancedRunning: Advanced Running
oldfreefolk: old free folk
dropship: dropship
Gameboy: Gameboy
ripcity: rip city
fermentation: fermentation
Eldenring: Eldenring
masterforgiveme: master forgive me
neoliberal: neoliberal
NailArt: Nail Art
cookingtonight: cooking tonight
longrange: long range
alberta: alberta
Catholicism: Catholicism
Urfavbaddiies: Ur fav baddies
SavageGarden: Savage Garden
KansasCityChiefs: Kansas City Chiefs
HistoryAnimemes: History Animemes
arma: arma
TreesSuckingOnThings: Trees Sucking On Things
DrugNerds: Drug Nerds
SiliconValleyHBO: Silicon Valley HBO
amazonecho: amazon echo
uglyduckling: ugly duckling
urbanplanning: urban planning
spaceengineers: space engineers
deadmalls: dead malls
reddeadfashion: red dead fashion
DnDHomebrew: DnD Homebrew
asexuality: asexuality
AskAnthropology: Ask Anthropology
pihole: pihole
Keto_Food: Keto Food
falcons: falcons
HardcoreNature: Hardcore Nature
thetagang: theta gang
Connecticut: Connecticut
spotted: spotted
aSongOfMemesAndRage: a Song Of Memes And Rage
ArtOfRolling: Art Of Rolling
Thunder: Thunder
MLBTheShow: MLB The Show
BeautyDiagrams: Beauty Diagrams
slavs_squatting: slavs squatting
EpicSeven: Epic Seven
RoleReversal: Role Reversal
AgainstHateSubreddits: Against Hate Subreddits
nipslips: nip slips
brutalism: brutalism
geology: geology
AlternativeHistory: Alternative History
bookclub: book club
GIMP: GIMP
Crystals: Crystals
DetailCraft: Detail Craft
Destiny: Destiny
JemWolfie: Jem Wolfie
cleanjokes: clean jokes
metalworking: metalworking
warcraftlore: warcraft lore
OCD: OCD
RachelCook: Rachel Cook
GoneMildPlus: Gone Mild Plus
spop: spop
nature: nature
ambien: ambien
NicoleDobrikov: Nicole Dobrikov
TerminallyStupid: Terminally Stupid
FortniteBattleRoyale: Fortnite Battle Royale
berlin: berlin
watchthingsfly: watchthingsfly
puppies: puppies
feminineboys: feminineboys
cutouts: cutouts
muacirclejerk: muacirclejerk
HybridAnimals: Hybrid Animals
recipegifs: recipegifs
soccercirclejerk: soccercirclejerk
starbound: starbound
dwarffortress: dwarffortress
TigerKing: Tiger King
Minneapolis: Minneapolis
drones: drones
ICanDrawThat: I Can Draw That
JustGuysBeingDudes: Just Guys Being Dudes
ScandinavianInterior: Scandinavian Interior
kateupton: kateupton
zerocarb: zerocarb
SuggestALaptop: Suggest A Laptop
photographs: photographs
steroids: steroids
futurebeats: futurebeats
bingingwithbabish: bingingwithbabish
singularity: singularity
SkinnyWithAbs: Skinny With Abs
dauntless: dauntless
shiba: shiba
lightsabers: lightsabers
RedLetterMedia: Red Letter Media
FallenOrder: Fallen Order
Rapekink: Rapekink
InsightfulQuestions: Insightful Questions
HipHopImages: Hip Hop Images
bikewrench: bikewrench
TheArtistStudio: The Artist Studio
n64: n64
pansexual: pansexual
greysanatomy: greysanatomy
fantanoforever: fantanoforever
AtlantaHawks: Atlanta Hawks
Addons4Kodi: Addons4Kodi
navy: navy
kingdomcome: kingdomcome
sonos: sonos
HungryArtists: Hungry Artists
summonerswar: summonerswar
StarWarsEU: Star Wars EU
ChineseLanguage: Chinese Language
vmware: vmware
AskHR: Ask HR
Porsche: Porsche
aoe2: aoe2
Tomorrowland: Tomorrowland
3Dmodeling: 3D modeling
WebGames: Web Games
Techno: Techno
weightlifting: weightlifting
WTFwish: WTF wish
gwent: gwent
AskParents: Ask Parents
Browns: Browns
thewitcher3: the witcher 3
JapaneseGameShows: Japanese Game Shows
writers: writers
lolcats: lolcats
churchporn: church porn
arrow: arrow
WWII: WWII
hungary: hungary
shittybattlestations: shitty battlestations
COVID19positive: COVID19 positive
FreaksNLeaks: Freaks N Leaks
Allsvenskan: Allsvenskan
ravens: ravens
gradadmissions: grad admissions
Quebec: Quebec
lastweektonight: last week tonight
SpaceBuckets: Space Buckets
paydaytheheist: payday the heist
shieldbro: shield bro
CompetitiveHS: Competitive HS
pittsburgh: pittsburgh
martialarts: martial arts
BatmanArkham: Batman Arkham
StreetMartialArts: Street Martial Arts
satisfying: satisfying
whatsthisworth: what's this worth
ultrawidemasterrace: ultra wide master race
nsfwanimegifs: nsfw anime gifs
doggos: doggos
KGBTR: KGBTR
AustralianPolitics: Australian Politics
InfowarriorRides: Infowarrior Rides
ubius: ubius
GrandTheftAutoV_PC: Grand Theft Auto V PC
careeradvice: career advice
Mid_Century: Mid Century
Wicca: Wicca
kratom: kratom
wallpaperengine: wallpaper engine
CPTSD: CPTSD
electricvehicles: electric vehicles
TeamSolomid: Team Solomid
MakeUpAddictionUK: Make Up Addiction UK
brokengifs: broken gifs
NSFW_Clothed: NSFW Clothed
Archaeology: Archaeology
WhatAWeeb: What A Weeb
RelayForReddit: Relay For Reddit
JackSucksAtLife: Jack Sucks At Life
cactus: cactus
researchchemicals: research chemicals
netolab: netolab
WorldofTanks: World of Tanks
phr4r: phr4r
blurrypicturesofcats: blurry pictures of cats
DisneyPlus: Disney Plus
audiodrama: audio drama
askcarsales: ask car sales
energy: energy
JenniferLawrence: Jennifer Lawrence
singing: singing
cannabiscultivation: cannabis cultivation
cakedecorating: cake decorating
TheHandmaidsTale: The Handmaid's Tale
ACT: ACT
discordservers: discord servers
lifting: lifting
YourJokeButWorse: Your Joke But Worse
AnimalsBeingMoms: Animals Being Moms
RetroGamePorn: Retro Game Porn
stunfisk: stunfisk
NewParents: New Parents
OsuSkins: Osu Skins
DJs: DJs
Notion: Notion
LogitechG: Logitech G
SalsaSnobs: Salsa Snobs
intj: intj
theydidthemonstermath: they did the monster math
mcservers: mc servers
sketches: sketches
pureasoiaf: pure asoiaf
JapaneseFood: Japanese Food
Deltarune: Deltarune
NEO: NEO
BestOfStreamingVideo: Best Of Streaming Video
MovieMistakes: Movie Mistakes
CannabisExtracts: Cannabis Extracts
gratefuldead: grateful dead
NBASpurs: NBA Spurs
croatia: croatia
abandoned: abandoned
malelifestyle: male lifestyle
HairDye: Hair Dye
NonBinary: Non Binary
MtF: MtF
denvernuggets: denver nuggets
HiTMAN: HiTMAN
killedthecameraman: killed the cameraman
autism: autism
SonyAlpha: Sony Alpha
FortniteCreative: Fortnite Creative
milanavayntrub: milana vayntrub
NoPoo: No Poo
counterstrike: counter-strike
cottontails: cottontails
greece: greece
SmallYTChannel: Small YT Channel
buildapcsalesuk: buildapcsalesuk
Pathfinder_RPG: Pathfinder RPG
netflixwitcher: netflix witcher
MaleFashionMarket: Male Fashion Market
ftm: ftm
BlackLivesMatter: Black Lives Matter
TalesFromTheSquadCar: Tales From The Squad Car
ThreadKillers: Thread Killers
whatsthisrock: what's this rock
OCPoetry: OCPoetry
koreanvariety: korean variety
czech: czech
Brittanya_Razavi_: Brittanya Razavi
surfing: surfing
AskNYC: Ask NYC
Pokemonart: Pokemon art
ACPocketCamp: AC Pocket Camp
SuperAthleteGifs: Super Athlete Gifs
wownoob: wow noob
nova: nova
steam_giveaway: steam giveaway
maryland: maryland
Fireteams: Fire teams
cat: cat
ReverseEngineering: Reverse Engineering
chefknives: chef knives
Cryptozoology: Cryptozoology
FuckNestle: Fuck Nestle
Switzerland: Switzerland
alternativeart: alternative art
Virginia: Virginia
justforsocialmedia: just for social media
MilitaryStories: Military Stories
WarplanePorn: Warplane Porn
OnlyFans: OnlyFans
sailing: sailing
swoleacceptance: swole acceptance
shortcircuit: short circuit
amazonreviews: amazon reviews
unclebens: uncle bens
nashville: nashville
thesopranos: the sopranos
Existentialism: Existentialism
lookatmydog: look at my dog
ems: EMS
antinatalism: antinatalism
bikecommuting: bike commuting
suns: suns
Liberal: Liberal
PokemonTCG: Pokemon TCG
C_Programming: C Programming
Israel: Israel
womenintrouble: women in trouble
groestlcoin: groestlcoin
RealBeesFakeTopHats: Real Bees Fake Top Hats
mylittlepony: my little pony
Stadia: Stadia
lawschooladmissions: law school admissions
DestructionPorn: Destruction Porn
W2S: W2S
paris: paris
burgers: burgers
RedditInTheKitchen: Reddit In The Kitchen
SharedBPM: Shared BPM
Fire: Fire
easyrecipes: easy recipes
climbharder: climb harder
onlyfansadvice: onlyfans advice
washingtonwizards: washington wizards
Dragonballsuper: Dragon Ball Super
Behzinga: Behzinga
Honda: Honda
JuiceWRLD: Juice WRLD
mspaint: ms paint
DeTrashed: De Trashed
R6ProLeague: R6 Pro League
papertowns: paper towns
90s: 90s
NFL_Draft: NFL Draft
physicsmemes: physics memes
Basketball: Basketball
birdpics: bird pics
googlemapsshenanigans: google maps shenanigans
AmateurArchives: Amateur Archives
xxketo: xxketo
PokemonROMhacks: Pokemon ROM hacks
waterporn: water porn
famiL: famiL
zen: zen
RASPBERRY_PI_PROJECTS: RASPBERRY PI PROJECTS
sad: sad
learnjava: learnjava
gamemusic: game music
snackexchange: snack exchange
TheAdventureZone: The Adventure Zone
wisconsin: wisconsin
DogsAndPlants: Dogs And Plants
flyfishing: fly fishing
timberwolves: timberwolves
Audi: Audi
phclassifieds: phclassifieds
DebateReligion: Debate Religion
explainlikeIAmA: explain like I Am A
BellaThorne: Bella Thorne
dune: dune
Izlam: Izlam
kodi: kodi
sugarlifestyleforum: sugar lifestyle forum
StudentLoans: Student Loans
InstaThots: Insta Thots
CleaningTips: Cleaning Tips
Scarymovies: Scary movies
windygirk: windygirk
HazbinHotel: Hazbin Hotel
VocabWordOfTheDay: Vocab Word Of The Day
inthenews: in the news
VPN: VPN
SacredGeometry: Sacred Geometry
gunpolitics: gun politics
OrganizationPorn: Organization Porn
Cubers: Cubers
d100: d100
bigboobproblems: big boob problems
riverdale: riverdale
infj: infj
YangForPresidentHQ: Yang For President HQ
codyko: codyko
magnetfishing: magnet fishing
bookshelf: bookshelf
China_Flu: China Flu
SubredditSimMeta: Subreddit Sim Meta
Prisonwallet: Prison wallet
Tronix: Tronix
twice: twice
BisexualTeens: Bisexual Teens
Starlink: star link
Korean: korean
slaythespire: slay the spire
lordoftherings: lord of the rings
smarthome: smart home
joinsquad: join squad
FilthyFrank: filthy Frank
doordash: door dash
Indiemakeupandmore: indie makeup and more
Skookum: skookum
MakeupRehab: makeup rehab
Gaming4Gamers: gaming for gamers
Gundam: gundam
BabyCorgis: baby corgis
Autoflowers: auto flowers
msp: msp
Chadtopia: chadtopia
Kappa: kappa
sadcats: sad cats
SkyrimMemes: skyrim memes
Indiana: Indiana
translator: translator
ValorantCompetitive: valorant competitive
suspiciousquotes: suspicious quotes
BanderitaX: banderita X
LAClippers: LA clippers
WackyTicTacs: wacky tic tacs
misfits: misfits
3dshacks: 3d shacks
AskScienceDiscussion: ask science discussion
WillNE: Will NE
rnb: rnb
incest: incest
Sissy: sissy
glassheads: glass heads
geography: geography
MuayThai: Muay Thai
ghettoglamourshots: ghetto glamour shots
AshleyTervort: Ashley Tervort
ketobeginners: keto beginners
Mandalorian: Mandalorian
HighHeels: high heels
riskofrain: risk of rain
flicks: flicks
ElsieHewitt: Elsie Hewitt
tmobile: t mobile
backrooms: back rooms
shittytattoos: shitty tattoos
whoooosh: whoooosh
Positive_News: positive news
IndiaInvestments: India investments
morbidlybeautiful: morbidly beautiful
DeadEyes: dead eyes
hittableFaces: hittable faces
cogsci: cogsci
TrueAtheism: true atheism
Socialism_101: socialism 101
F1Porn: F1 porn
Portal: portal
rance: rance
criterion: criterion
indiegames: indie games
CatsInSinks: cats in sinks
fairytail: fairy tail
snes: SNES
DevilMayCry: Devil May Cry
vita: vita
Journaling: journaling
CompTIA: CompTIA
VinylDeals: vinyl deals
AnimalsBeingConfused: animals being confused
Transmogrification: transmogrification
KingkillerChronicle: Kingkiller Chronicle
SwitchHacks: switch hacks
indianews: India news
RedditInReddit: Reddit in Reddit
UtahJazz: Utah Jazz
guitarporn: guitar porn
sfx: sfx
SubsIFellFor: subs I Fell For
HostileArchitecture: hostile architecture
rawdenim: raw denim
ParentsAreFuckingDumb: parents are fucking dumb
PsychologicalTricks: psychological tricks
MawInstallation: Maw Installation
beatsaber: beat saber
HeistTeams: heist teams
UnexplainedPhotos: unexplained photos
SonicTheHedgehog: Sonic The Hedgehog
TsundereSharks: tsundere sharks
yourmomshousepodcast: your mom's house podcast
botany: botany
AMADisasters: AMA disasters
drugscirclejerk: drugs circle jerk
longhair: long hair
AskSocialScience: ask social science
SophieM: Sophie M
motogp: Moto GP
Construction: construction
estoration: estoration
Magic: magic
NewsOfTheStupid: news of the stupid
airplaneears: airplane ears
fnafcringe: fnaf cringe
Battlecars: battle cars
christmas: Christmas
Unclejokes: uncle jokes
britishcolumbia: British Columbia
irlsmurfing: IRL smurfing
vegetablegardening: vegetable gardening
MBA: MBA
Chromecast: Chromecast
detroitlions: Detroit Lions
cardsagainsthumanity: cards against humanity
Komi_san: Komi san
iOSProgramming: iOS programming
shittytechnicals: shitty technicals
SovietWomble: Soviet Womble
ThickFit: Thick Fit
IndianFood: Indian food
undelete: undelete
EnoughTrumpSpam: enough Trump spam
chrome: Chrome
bassfishing: bass fishing
HumanTippyTaps: human tippy taps
TwoXSex: Two X Sex
wedding: wedding
DenverBroncos: Denver Broncos
UpvotedBecauseBoobs: upvoted because boobs
cocaine: cocaine
Xcom: Xcom
shittymobilegameads: shitty mobile game ads
orlando: Orlando
neuroscience: neuroscience
thepiratebay: the pirate bay
Machinists: machinists
DaniDev: Dani Dev
corinnakopf: Corinna Kopf
RedditForGrownups: Reddit for grownups
drugstoreMUA: drugstore MUA
garlicoin: garlicoin
analytics: analytics
adultery: adultery
girlsdoporn: girls do porn
Residency: residency
HollowKnightMemes: Hollow Knight memes
judo: judo
TropicalWeather: tropical weather
Trucks: trucks
PressureCooking: pressure cooking
tldr: tldr
newyorkcity: New York City
northernireland: Northern Ireland
nattyorjuice: natty or juice
ElectricalEngineering: electrical engineering
Nailpolish: nail polish
Healthy_Recipes: healthy recipes
GYM: GYM
spiders: spiders
see: see
Lifebrotips: life bro tips
hinduism: Hinduism
progmetal: prog metal
30ROCK: 30 ROCK
ECE: ECE
NationalPark: National Park
NYGiants: NY Giants
Finanzen: Finanzen
FaceFirstNSFW: face first NSFW
AdobeIllustrator: Adobe Illustrator
applehelp: apple help
NonZeroDay: non zero day
JustNoSO: just no SO
natureporn: nature porn
Nicki_Minaj: Nicki Minaj
R4R30Plus: R4R 30 Plus
Stock_Picks: stock picks
animalcrossingdesign: animal crossing design
husky: husky
massachusetts: Massachusetts
scuba: scuba
oregon: Oregon
kings: kings
Cartoon_Porn: cartoon porn
RoastMyCar: roast my car
Workbenches: workbenches
Ubiquiti: Ubiquiti
ShitCosmoSays: Shit Cosmo Says
loltyler1: lol tyler1
Mordhau: Mordhau
cheating_stories: cheating stories
CruciblePlaybook: Crucible Playbook
LazarBeam: LazarBeam
syriancivilwar: Syrian civil war
OkBubbyRetard: Ok Bubby Retard
pharmacy: pharmacy
magick: magick
TooBig: too big
ihavereddit: I have reddit
mapmaking: map making
hotsauce: hot sauce
GamerPals: gamer pals
guineapigs: guinea pigs
ImaginaryWarhammer: imaginary Warhammer
bullybackfire: bully backfire
badassanimals: badass animals
mildlyvagina: mildly vagina
SnapChad: Snap Chad
evangelionmemes: Evangelion memes
watch_dogs: watch dogs
TwinCities: Twin Cities
Standup: standup
NoFeeAC: no fee AC
aspergers: Aspergers
catsonglass: cats on glass
ArtHistory: art history
NSFW_5seconds: NSFW 5 seconds
bapcsalescanada: bapcsales canada
LSAT: LSAT
psychotherapy: psychotherapy
TheGamerLounge: The Gamer Lounge
Anthropology: anthropology
BigTitsButClothed: big tits but clothed
netsecstudents: net sec students
armoredwomen: armored women
dotnet: dot net
WorldOfWarships: World of Warships
IPTV: IPTV
HorriblyDepressing: horribly depressing
Otters: otters
ElsaGate: Elsa Gate
terrariums: terrariums
Ornithology: ornithology
DarwinAwards: Darwin Awards
Cheese: cheese
washingtonNFL: Washington NFL
UnexpectedThanos: unexpected Thanos
scambait: scam bait
americandad: American Dad
dreampop: dream pop
Thatsabooklight: that's a book light
ExplainLikeImCalvin: Explain Like I'm Calvin
CoronavirusMemes: coronavirus memes
7daystodie: 7 days to die
HoldMyKibble: hold my kibble
whatstheword: what's the word
polyamoryR4R: polyamory R4R
ALLTHEANIMALS: all the animals
TheWeeknd: The Weeknd
dubai: Dubai
nihilism: nihilism
SWGalaxyOfHeroes: SW Galaxy Of Heroes
beginnerfitness: beginner fitness
mauerstrassenwetten: mauerstrassenwetten
LilPeep: Lil Peep
women: women
AlexisRen: Alexis Ren
illusionporn: illusion porn
holdmybeaker: hold my beaker
AskWomenOver30: ask women over 30
RLFashionAdvice: RL Fashion Advice
hamiltonmusical: Hamilton musical
rally: rally
Colombia: Colombia
classiccars: classic cars
MelissaDebling: Melissa Debling
es: es
pokemongotrades: Pokemon Go trades
PetiteFashionAdvice: petite fashion advice
Currentlytripping: currently tripping
absoluteunit: absolute unit
HBOGameofThrones: HBO Game of Thrones
StarWarsTattoo: Star Wars Tattoo
rockhounds: rock hounds
puzzles: puzzles
Cameras: cameras
bartenders: bartenders
Beekeeping: beekeeping
TheBestOfAmazon: the best of Amazon
continuityporn: continuity porn
BootyfulWomen: bootyful women
yakuzagames: Yakuza games
Morrowind: Morrowind
investimentos: investimentos
cute: cute
computers: computers
CovIdiots: Covid Idiots
SubsYouFellFor: subs you fell for
incremental_games: incremental games
beyonce: Beyonce
MapsWithoutNZ: Maps without NZ
xmen: X-Men
Unity2D: Unity 2D
CriticalTheory: critical theory
cromch: cromch
Beachporn: beach porn
needforspeed: need for speed
BadChoicesGoodStories: bad choices good stories
DestroyedTanks: Destroyed Tanks
InfraredPorn: infrared porn
HYPERSCAPE: HYPERSCAPE
Miata: Miata
GhostRecon: Ghost Recon
UniversityofReddit: University of Reddit
creativewriting: creative writing
lifeisstrange: life is strange
steinsgate: steins gate
circojeca: circo jeca
neutralnews: neutral news
AmateurGroups: Amateur Groups
Lightbulb: light bulb
4x4: 4x4
mobilelegends: mobile legends
HarryPotterMemes: Harry Potter Memes
RoughRomanMemes: Rough Roman Memes
AppalachianTrail: Appalachian Trail
Enhancement: enhancement
cookingvideos: cooking videos
PPC: PPC
redditbay: reddit bay
Archery: archery
LegalAdviceEurope: Legal Advice Europe
indonesia: indonesia
MaddenUltimateTeam: Madden Ultimate Team
FFVIIRemake: Final Fantasy VII Remake
streetart: street art
leotards: leotards
CircleofTrust: Circle of Trust
Columbus: Columbus
F1Game: F1 Game
BrutalBeatdowns: Brutal Beatdowns
DarthJarJar: Darth Jar Jar
megalinks: mega links
badphilosophy: bad philosophy
zombies: zombies
Emo: emo
Volumeeating: volume eating
reptiles: reptiles
woesenpai69: wo esenpai 69
worldofpvp: world of pvp
buffalobills: buffalo bills
Carpentry: carpentry
TameImpala: tame impala
Anarchy101: Anarchy 101
BabyYoda: Baby Yoda
chadsriseup: chads rise up
MakeupAddictionCanada: Makeup Addiction Canada
RiskyPorn: risky porn
DealsReddit: Deals Reddit
simpsonsshitposting: simpsons shitposting
seashanties: sea shanties
techwearclothing: techwear clothing
Epstein: Epstein
Target: Target
IWantItSoBad: I Want It So Bad
AudioPost: Audio Post
diamondpainting: diamond painting
motorsportsstreams: motorsports streams
kotor: kotor
weekendgunnit: weekend gunnit
AskTrumpSupporters: Ask Trump Supporters
SelfSufficiency: Self Sufficiency
Barca: Barca
Antiques: antiques
TerrainBuilding: terrain building
HappyWoofGifs: Happy Woof Gifs
Miami: Miami
macsetups: mac setups
LPOTL: LPOTL
seinfeldgifs: seinfeld gifs
TowerofGod: Tower of God
worldevents: world events
NiceHash: NiceHash
HomeKit: HomeKit
gallifrey: gallifrey
Bikeporn: bike porn
IndieDev: Indie Dev
bedroompop: bedroom pop
traderjoes: Trader Joe's
taiwan: Taiwan
randomsexygifs: random sexy gifs
triathlon: triathlon
GreatXboxDeals: Great Xbox Deals
SteamGameSwap: Steam Game Swap
OldSchoolCelebs: Old School Celebs
germanshepherds: german shepherds
MobileWallpaper: Mobile Wallpaper
BrieLarson: Brie Larson
ihaveihaveihavereddit: I Have I Have I Have Reddit
hellsomememes: hell some memes
dogs_getting_dogs: dogs getting dogs
bonehealingjuice: bone healing juice
FBIOpenUp: FBI Open Up
cardistry: cardistry
GTBAE: GTBAE
Market76: Market 76
trump: Trump
DaftPunk: Daft Punk
toofers: toofers
awwnverts: awwnverts
buildmeapc: build me a pc
NOLAPelicans: NOLA Pelicans
trailmeals: trail meals
LizKatz: Liz Katz
wallstreetbetstest: wallstreet bets test
NYYankees: NY Yankees
DetroitPistons: Detroit Pistons
mentalillness: mental illness
amiibo: amiibo
spikes: spikes
YouFellForItFool: You Fell For It Fool
TrueDetective: True Detective
Saints: Saints
Norway: Norway
Pyongyang: Pyongyang
Fantasy_Football: Fantasy Football
spain: Spain
dechonkers: dechonkers
PrettyGirlsUglyFaces: Pretty Girls Ugly Faces
DuggarsSnark: Duggars Snark
Anxietyhelp: Anxiety Help
AndroidQuestions: Android Questions
AsABlackMan: As A Black Man
LaurenSummer: Lauren Summer
trapmuzik: trap muzik
deathnote: death note
SelenaGomez: Selena Gomez
SQL: SQL
Watchmen: Watchmen
Notakeonlythrow: Not A Ke Only Throw
AutumnPorn: Autumn Porn
gonecivil: gonecivil
cozy: cozy
ValueInvesting: Value Investing
FifthWorldPics: Fifth World Pics
supportlol: support lol
CompetitiveTFT: Competitive TFT
Ebay: Ebay
deepseacreatures: deep sea creatures
cemu: cemu
Volkswagen: Volkswagen
Xenoblade_Chronicles: Xenoblade Chronicles
DylanteroYT: Dylantero YT
Purrito: purrito
Multicopter: multicopter
mythology: mythology
juststart: just start
NZXT: NZXT
StudentNurse: Student Nurse
RenewableEnergy: Renewable Energy
SocialistRA: Socialist RA
CoronavirusUK: Coronavirus UK
momson: mom son
Amsterdam: Amsterdam
mountainbiking: mountain biking
Maps: Maps
Charlotte: Charlotte
starwarsrebels: Star Wars Rebels
DamnNatureYouScary: Damn Nature You Scary
MoeMorphism: Moe Morphism
IrrationalMadness: Irrational Madness
medievaldoctor: medieval doctor
django: django
exmuslim: ex muslim
Glocks: Glocks
Roll20: Roll20
truecreepy: true creepy
TheBluePill: The Blue Pill
Goatparkour: goat parkour
BuddyCrossing: Buddy Crossing
VietNam: Vietnam
pacers: pacers
coys: COYS
Professors: Professors
identifythisfont: identify this font
MemesIRL: Memes IRL
nanocurrency: nano currency
CraftBeer: Craft Beer
Detroit: Detroit
medicalschoolanki: medical school anki
tacobell: Taco Bell
MeatlessMealPrep: Meatless Meal Prep
Best_tattoos: Best tattoos
TheDarwinProject: The Darwin Project
AliensAmongUs: Aliens Among Us
realmadrid: real madrid
blackops3: black ops 3
climate: climate
ZettaiRyouiki: Zettai Ryouiki
PokemonLetsGo: Pokemon Let's Go
wilbursoot: wilbur soot
SuddenlyIncest: Suddenly Incest
Egypt: Egypt
Crypto_Currency_News: Crypto Currency News
HighschoolDxD: Highschool DxD
accidentalswastika: accidental swastika
workout: workout
OrlandoMagic: Orlando Magic
FreeKarma4You: Free Karma For You
Stargate: Stargate
DestinyMemes: Destiny Memes
TrueDoTA2: True Do TA2
deadcells: dead cells
CallMeKevin: Call Me Kevin
adamsilverfanpage: Adam Silver Fan Page
coronabr: coronabr
ww2: ww2
CrackSupport: Crack Support
Semenretention: semen retention
SwitchHaxing: Switch Haxing
DeepRockGalactic: Deep Rock Galactic
customhearthstone: custom hearthstone
DaenerysWinsTheThrone: Daenerys Wins The Throne
TeenMomOGandTeenMom2: Teen Mom OG and Teen Mom 2
VRchat: VR Chat
RainbowSixSiege: Rainbow Six Siege
KidCudi: Kid Cudi
AndroidTV: Android TV
velvethippos: velvet hippos
Dodgers: Dodgers
confusingperspective: confusing perspective
buccaneers: buccaneers
tampa: Tampa
NamFlashbacks: Nam Flashbacks
CharlotteHornets: Charlotte Hornets
SaltLakeCity: Salt Lake City
shittyadvice: shitty advice
Mosses: Mosses
HQDesi: HQ Desi
braziliangirls: brazilian girls
AntifascistsofReddit: Anti Fascists of Reddit
mariokart: Mario Kart
modhelp: mod help
redsox: Red Sox
TouchThaFishy: Touch Tha Fishy
myog: myog
mealprep: meal prep
laptops: laptops
CaptainSparklez: Captain Sparklez
stolendogbeds: stolen dog beds
ExtraFabulousComics: Extra Fabulous Comics
ask: ask
52weeksofcooking: 52 weeks of cooking
RapLeaks: Rap Leaks
miamidolphins: Miami Dolphins
badUIbattles: bad UI battles
Stims: stims
Blogging: blogging
FFXV: Final Fantasy XV
demonssouls: demons souls
SubsTakenLiterally: Subs Taken Literally
kettlebell: kettlebell
falloutsettlements: fallout settlements
exchristian: ex christian
bidenbro: Biden Bro
CryptoCurrencyTrading: Crypto Currency Trading
SomeOrdinaryGmrs: Some Ordinary Gamers
Mountaineering: mountaineering
Shitstatistssay: Shit Statists Say
MarioMaker: Mario Maker
WayOfTheBern: Way Of The Bern
TurnipExchange: Turnip Exchange
streetfoodartists: street food artists
xmrtrader: xmr trader
earrumblersassemble: ear rumblers assemble
Mustang: Mustang
WeatherPorn: Weather Porn
RedditMasterClasses: Reddit Master Classes
MargotRobbie: Margot Robbie
goth: goth
learndota2: learn dota 2
raleigh: Raleigh
fiaustralia: FI Australia
kittengifs: kitten gifs
ImaginaryDragons: Imaginary Dragons
bridezillas: bridezillas
excgarated: excgarated
VinylCollectors: Vinyl Collectors
mumbai: Mumbai
Norse: Norse
longevity: longevity
Empaths: empaths
CapitalismVSocialism: Capitalism VS Socialism
neckbeardRPG: neckbeard RPG
memphisgrizzlies: memphis grizzlies
wildrift: Wild Rift
malepolish: male polish
bengals: Bengals
PathOfExileBuilds: Path of Exile Builds
Backcountry: backcountry
TenseiSlime: Tensei Slime
comedy: comedy
taoism: taoism
Bladesmith: bladesmith
valkyrae: Valkyrae
amateurradio: amateur radio
LuLaNo: LuLaNo
JoeBiden: Joe Biden
VirtualYoutubers: Virtual YouTubers
PhilosophyofScience: Philosophy of Science
transpassing: trans passing
LaserCleaningPorn: Laser Cleaning Porn
picrequests: pic requests
Jarrariums: Jarrariums
amateur_boxing: amateur boxing
CoronavirusCA: Coronavirus CA
JennaJade: Jenna Jade
Paleontology: Paleontology
RPClipsGTA: RP Clips GTA
BossfightUniverse: Bossfight Universe
pakistan: pakistan
content_marketing: content marketing
Maplestory: Maplestory
AskPhysics: Ask Physics
IBO: IBO
scrungycats: scrungy cats
garageporn: garage porn
AlbumArtPorn: Album Art Porn
wowservers: wowservers
Swimming: Swimming
fakedisordercringe: fake disorder cringe
EmiliaClarke: Emilia Clarke
iRacing: i Racing
Legoyoda: Legoyoda
IndianGaming: Indian Gaming
cirkeltrek: cirkeltrek
NarcissisticAbuse: Narcissistic Abuse
unexpectedhogwarts: unexpected hogwarts
madmen: madmen
subsithoughtifellfor: subs i thought i fell for
pregnant: pregnant
FromKittenToCat: From Kitten To Cat
Defenders: Defenders
GearsOfWar: Gears Of War
vegan1200isplenty: vegan 1200 is plenty
poppunkers: pop punkers
relationshipadvice: relationship advice
bannedfromclubpenguin: banned from club penguin
ferrets: ferrets
watchplantsgrow: watch plants grow
ThatsHowThingsWork: That's How Things Work
FoodLosAngeles: Food Los Angeles
girlsfrontline: girls frontline
eos: eos
RocketLeagueEsports: Rocket League Esports
Kirby: Kirby
KidsAreFuckingEvil: Kids Are Fucking Evil
bugout: bugout
teenagersnew: teenagers new
everyfuckingthread: every fucking thread
HuntShowdown: Hunt Showdown
GripTraining: Grip Training
hiphop: hip hop
StLouis: St Louis
css: css
talesfromsecurity: tales from security
thepromisedneverland: the promised neverland
NuxTakuSubmissions: Nux Taku Submissions
MarvelStrikeForce: Marvel Strike Force
bigfoot: bigfoot
Images: Images
11foot8: 11 foot 8
GoldandBlack: Gold and Black
RedditWritesSeinfeld: Reddit Writes Seinfeld
Plumbing: Plumbing
csMajors: cs Majors
CoronavirusRecession: Coronavirus Recession
Nioh: Nioh
Indiangirlsontinder: Indian girls on tinder
synthrecipes: synth recipes
FortniteFashion: Fortnite Fashion
Unemployment: Unemployment
HUEstation: H U E station
accidentallycommunist: accidentally communist
ncaaBBallStreams: ncaa B Ball Streams
transpositive: transpositive
linuxmemes: linux memes
Fishing_Gear: Fishing Gear
penspinning: pen spinning
mead: mead
eldertrees: elder trees
TheDragonPrince: The Dragon Prince
CompanyBattles: Company Battles
AnadeArmas: Anade Armas
supersmashbros: super smash bros
Kayaking: Kayaking
ModernMagic: Modern Magic
StrugglePorn: Struggle Porn
sneakerreps: sneaker reps
intrusivethoughts: intrusive thoughts
HotPeppers: Hot Peppers
Crazyppl: Crazyppl
redpandas: red pandas
HuskyTantrums: Husky Tantrums
Business_Ideas: Business Ideas
pelletgrills: pellet grills
artstore: art store
consoledeals: console deals
grindr: grindr
Telegram: Telegram
Kaiserreich: Kaiserreich
Nirvana: Nirvana
Getdownmrpresident: Get down mr president
titleporn: title porn
MCFC: M C F C
BeckyCrocker: Becky Crocker
NatureGifs: Nature Gifs
Songwriters: Songwriters
lossofalovedone: loss of a loved one
Chefit: Chef it
ageofsigmar: age of sigmar
ARG: ARG
alcohol: alcohol
grammar: grammar
DOG: DOG
StarWarsCantina: Star Wars Cantina
blackfriday: black friday
mtgfinance: mtg finance
coins: coins
Memeulous: Memeulous
USMC: USMC
HITsWorthTurkingFor: HITs Worth Turking For
ComedyHitmen: Comedy Hitmen
insomnia: insomnia
RuinedMyDay: Ruined My Day
tretinoin: tretinoin
Emuwarflashbacks: Emuwarflashbacks
pugs: pugs
MimicRecipes: Mimic Recipes
dataisugly: dataisugly
vintageads: vintage ads
Achievement_Hunter: Achievement Hunter
boneachingjuice: boneachingjuice
shrimptank: shrimp tank
asktrp: ask trp
Corsair: Corsair
wewantcups: we want cups
lost: lost
MrBeast: Mr Beast
wallstreetbets2: wallstreetbets2
kansascity: kansas city
EOOD: EOOD
AwardSpeechEdits: Award Speech Edits
gmod: gmod
PostHardcore: Post Hardcore
manchester: manchester
OpenSignups: Open Signups
ZeroTwo: Zero Two
simpsonsdidit: simpsonsdidit
SSBM: SSBM
EnglishLearning: English Learning
adultswim: adult swim
lectures: lectures
houkai3rd: houkai3rd
bruhmoment: bruh moment
ElizabethOlsen: Elizabeth Olsen
arcticmonkeys: arctic monkeys
PussyPass: Pussy Pass
conservatives: conservatives
greebles: greebles
PornAttack: Porn Attack
vegancirclejerk: vegan circle jerk
BasicIncome: Basic Income
Silverbugs: Silverbugs
JennaLynnMeowri: Jenna Lynn Meowri
ApexConsole: Apex Console
coupons: coupons
farming: farming
nyjets: ny jets
panelshow: panel show
rockstar: rock star
SwagBucks: Swag Bucks
samharris: Sam Harris
DiretoDoZapZap: Direto Do Zap Zap
jschlatt: jschlatt
Gamemeneersubmissies: Gamemeneersubmissies
Beatmatch: Beat match
aaaaaaacccccccce: aaaaaaacccccccce
heat: heat
firstimpression: first impression
Androgynoushotties: Androgynous hotties
swift: swift
TwoBestFriendsPlay: Two Best Friends Play
AdvancedFitness: Advanced Fitness
DestinySherpa: Destiny Sherpa
TheGrittyPast: The Gritty Past
ScenesFromAHat: Scenes From A Hat
ReasonableFantasy: Reasonable Fantasy
Second: Second
finedining: fine dining
MandJTV: MandJTV
Affiliatemarketing: Affiliate marketing
skinwalkers: skinwalkers
Waxpen: Wax pen
Kerala: Kerala
trendingsubreddits: trending subreddits
FloridaCoronavirus: Florida Coronavirus
Blizzard: Blizzard
phinvest: ph invest
Bandnames: Band names
steampunk: steampunk
GameSale: Game Sale
sportsbetting: sports betting
PhantomForces: Phantom Forces
FFBraveExvius: FF Brave Exvius
muacjdiscussion: muacj discussion
Ladybonersgonecuddly: Lady boners gone cuddly
gtavcustoms: gtav customs
steelseries: steelseries
xbox360: xbox 360
Petioles: Petioles
MisleadingPuddles: Misleading Puddles
gofundme: go fund me
Sacramento: Sacramento
GaySoundsShitposts: Gay Sounds Shitposts
vintage: vintage
DimensionalJumping: Dimensional Jumping
nonmonogamy: nonmonogamy
AnimeFigures: Anime Figures
beermoneyglobal: beermoney global
vikingstv: vikings tv
benzodiazepines: benzodiazepines
onepotmeals: one pot meals
curlygirl: curly girl
Ellesclub: Elles club
low_poly: low poly
sanantonio: san antonio
LiveFromNewYork: Live From New York
digimon: digimon
festivals: festivals
giftcardexchange: gift card exchange
onewordeach: one word each
shameless: shameless
TyrionWinsTheThrone: Tyrion Wins The Throne
orangeisthenewblack: orange is the new black
PhasmophobiaGame: Phasmophobia Game
Agraelus: Agraelus
Neuropsychology: Neuropsychology
teaching: teaching
Chiraqology: Chiraqology
panthers: panthers
rva: rva
mturk: mturk
Bitcoincash: Bitcoin cash
assettocorsa: assettocorsa
BillBurr: Bill Burr
Blessed_Images: Blessed Images
FierceFlow: Fierce Flow
SchittsCreek: Schitts Creek
Posture: Posture
The100: The 100
foundfelix: found felix
orchids: orchids
sbeve: sbeve
samoyeds: samoyeds
SluttyStrangers: Slutty Strangers
unexpectedcommunism: unexpected communism
OverwatchLeague: Overwatch League
arielwinter: Ariel Winter
synology: synology
Finland: Finland
My600lbLife: My 600lb Life
Vermintide: Vermintide
actualconspiracies: actual conspiracies
HistoryWhatIf: History What If
VegRecipes: Veg Recipes
userexperience: user experience
extremelyinfuriating: extremely infuriating
dontbestupid: dont be stupid
NanatsunoTaizai: Nanatsuno Taizai
FashionRepsBST: FashionReps BST
BossFights: Boss Fights
admincraft: admin craft
doordash_drivers: doordash drivers
homelabsales: home lab sales
ContraPoints: Contra Points
Truckers: Truckers
satanism: satanism
TinyUnits: Tiny Units
peloton: peloton
TrollCoping: Troll Coping
noveltranslations: novel translations
AcademicPsychology: Academic Psychology
CommunismMemes: Communism Memes
sociology: sociology
Scholar: Scholar
MarchAgainstTrump: March Against Trump
rocketbeans: rocket beans
GamingLaptops: Gaming Laptops
notebooks: notebooks
TheCuddlePuddle: The Cuddle Puddle
japanese: japanese
scottthewoz: scottthewoz
frogs: frogs
INDYCAR: INDYCAR
WholesomeComics: Wholesome Comics
Greekgodx: Greekgodx
watercooling: water cooling
tressless: tressless
BusinessIntelligence: Business Intelligence
Broadway: Broadway
Mario: Mario
MobileLegendsGame: Mobile Legends Game
PutYourDickInThat: Put Your Dick In That
antifastonetoss: antifastonetoss
telescopes: telescopes
ironscape: ironscape
borrow: borrow
fitbit: fitbit
timelapse: time lapse
Helltaker: Helltaker
PFSENSE: PFSENSE
OreGairuSNAFU: Ore Gairu SNAFU
DisneyEyes: Disney Eyes
WarframeRunway: Warframe Runway
restaurant: restaurant
lifeofnorman: life of norman
metaldetecting: metal detecting
editors: editors
algorithms: algorithms
JurassicPark: Jurassic Park
robloxgamedev: robloxgamedev
stories: stories
Exercise: Exercise
gentlemanbonersgifs: gentleman boners gifs
MotorcyclePorn: Motorcycle Porn
tinyanimalsonfingers: tiny animals on fingers
BeardedDragons: Bearded Dragons
GetMoreViewsYT: Get More Views YT
Dentistry: Dentistry
ChainsawMan: Chainsaw Man
weather: weather
WaxSealers: Wax Sealers
breakingmom: breaking mom
TPB: TPB
Traeger: Traeger
ShittyGifRecipes: Shitty Gif Recipes
askpsychology: ask psychology
LakeLaogai: Lake Laogai
ManchesterUnited: Manchester United
NarcoFootage: Narco Footage
sideloaded: sideloaded
annakendrick: anna kendrick
NewOrleans: New Orleans
AverageBattlestations: Average Battlestations
CoronavirusWA: Coronavirus WA
cults: cults
conceptart: concept art
ancientrome: ancient rome
saltierthancrait: saltier than crait
PlantIdentification: Plant Identification
Weddingsunder10k: Weddings under 10k
adorableoldpeople: adorable old people
TheBrewery: The Brewery
SanJose: San Jose
cryptonasa: cryptonasa
CrazyHand: Crazy Hand
wildbeef: wild beef
bigseo: big seo
kayakfishing: kayak fishing
LanaRhoadesX: Lana Rhoades X
mystery: mystery
baltimore: baltimore
blogsnark: blog snark
Drifting: Drifting
DeathByMillennial: Death By Millennial
BitchImATrain: Bitch I'm A Train
DnDIY: DnD DIY
Cinema4D: Cinema 4D
foodscam: food scam
PhoenixSC: Phoenix SC
neuro: neuro
averageredditor: average redditor
MakingaMurderer: Making a Murderer
Megaten: Megaten
brandonsanderson: brandon sanderson
Beastars: Beastars
PurplePillDebate: Purple Pill Debate
WtWFotMJaJtRAtCaB: WtWFotMJaJtRAtCaB
McMansionHell: McMansion Hell
bicycletouring: bicycle touring
SSSniperWolf_Pics: SSSniperWolf Pics
AskAstrologers: Ask Astrologers
GettingShredded: Getting Shredded
touhou: touhou
GearTrade: Gear Trade
VillagePorn: Village Porn
nonmurdermysteries: non murder mysteries
truechildfree: true childfree
TheCloneWars: The Clone Wars
VinylReleases: Vinyl Releases
Qult_Headquarters: Qult Headquarters
DebateAnAtheist: Debate An Atheist
AskThe_Donald: Ask The Donald
WWEGames: WWE Games
DemonSlayerAnime: Demon Slayer Anime
serbia: serbia
HomeServer: Home Server
quilting: quilting
BaldursGate3: Baldurs Gate 3
Dexter: Dexter
drugmemes: drug memes
TheForest: The Forest
birthcontrol: birth control
perth: perth
GameStop: GameStop
RTLSDR: RTLSDR
Catsmirin: Catsmirin
therapy: therapy
nes: nes
TellMeAFact: Tell Me A Fact
badparking: bad parking
ImagineThisView: Imagine This View
esports: esports
migraine: migraine
TheCritshow: The Critshow
freegames: free games
darkstockphotos: dark stock photos
SoFuckable: So Fuckable
vzla: vzla
emmaglover: emma glover
LineageOS: Lineage OS
FitLifeVideos: Fit Life Videos
AskHistory: Ask History
SrGrafo: Sr Grafo
CyanideandHappiness: Cyanide and Happiness
reactionpics: reaction pics
ArtistLounge: Artist Lounge
FundieSnark: Fundie Snark
Planetside: Planetside
Fiveheads: Fiveheads
Adulting: Adulting
icocrypto: icocrypto
ActionFigures: Action Figures
NFT: NFT
reactnative: react native
MtvChallenge: Mtv Challenge
HistoricalWhatIf: Historical What If
terriblefandommemes: terrible fandom memes
Ask_Politics: Ask Politics
Hornyjail: Horny jail
OldManDog: Old Man Dog
language_exchange: language exchange
fpvracing: fpv racing
CustomKeyboards: Custom Keyboards
PetsareAmazing: Pets are Amazing
MusicBattlestations: Music Battlestations
AccidentalSlapStick: Accidental Slap Stick
castlevania: castlevania
Shoplifting: Shoplifting
ProCreate: Pro Create
ATLA: ATLA
iwatchedanoldmovie: i watched an old movie
breastfeeding: breastfeeding
falloutnewvegas: fallout new vegas
unknownvideos: unknown videos
ThisIsOurMusic: This Is Our Music
anonymous: anonymous
darkhumorjokes: dark humor jokes
LV426: LV426
itrunsdoom: it runs doom
SWORDS: SWORDS
ikeahacks: ikea hacks
SteamVR: Steam VR
Jung: Jung
bulgaria: bulgaria
interesting: interesting
Canning: Canning
TraceAnObject: Trace An Object
humblebundles: humble bundles
DrStone: Dr Stone
lynaritaa: lynaritaa
depressed: depressed
SamONellaAcademy: Sam O Nella Academy
TapTitans2: Tap Titans 2
DeFranco: De Franco
Washington: Washington
StrongCurves: Strong Curves
DaystromInstitute: Daystrom Institute
trance: trance
GreenAndPleasant: Green And Pleasant
Aliexpress: Aliexpress
Papaplatte: Papaplatte
Offensive_Wallpapers: Offensive Wallpapers
HaloOnline: Halo Online
SubSimulatorGPT2: Sub Simulator GPT2
MonsterHunterMeta: Monster Hunter Meta
AZCardinals: AZ Cardinals
AceAttorney: Ace Attorney
Texans: Texans
AionNetwork: Aion Network
DetroitBecomeHuman: Detroit Become Human
lowendgaming: low end gaming
RiseofKingdoms: Rise of Kingdoms
birthofasub: birth of a sub
TheWire: The Wire
usenet: usenet
Wallstreetsilver: Wallstreetsilver
victoria2: victoria 2
buffy: buffy
CuteTraps: Cute Traps
blurrypicturesofdogs: blurry pictures of dogs
MatthiasSubmissions: Matthias Submissions
Fighters: Fighters
ElizabethTurner: Elizabeth Turner
SGExams: SG Exams
DnB: DnB
Coachella: Coachella
museum: museum
japanesestreetwear: japanese streetwear
composting: composting
ccna: ccna
SideProject: Side Project
startrekgifs: star trek gifs
BestOfLiveleak: Best Of Liveleak
Monterrey: Monterrey
5ToubunNoHanayome: 5 Toubun No Hanayome
canucks: canucks
youtubegaming: youtube gaming
cobrakai: cobra kai
unlikelyfriends: unlikely friends
MBMBAM: MBMBAM
Tierzoo: Tierzoo
TanaMongeau: Tana Mongeau
SigSauer: Sig Sauer
filipinofood: filipino food
GirlsWithHugePussies: Girls With Huge Pussies
StressFreeSeason: Stress Free Season
HVAC: HVAC
cutelittlefangs: cute little fangs
ukhiphopheads: UK Hip Hop Heads
macgaming: mac gaming
FulfillmentByAmazon: Fulfillment By Amazon
KillLaKill: Kill La Kill
diabetes: diabetes
trailers: trailers
dragonquest: dragon quest
80sdesign: 80s design
BrawlStarsCompetitive: Brawl Stars Competitive
design_critiques: design critiques
straya: straya
Genealogy: Genealogy
MovieStreamingSites: Movie Streaming Sites
progressive: progressive
Georgia: Georgia
ThisDayInHistory: This Day In History
EDanonymemes: EDanonymemes
AskGayMen: Ask Gay Men
Thailand: Thailand
TFHcooking: TFH cooking
visualization: visualization
Veterans: Veterans
gameDevClassifieds: game Dev Classifieds
vitahacks: vitahacks
socialmilf: social milf
AppleMusic: Apple Music
CFA: CFA
badMovies: bad Movies
shroomers: shroomers
PlanetCoaster: Planet Coaster
KeepWriting: Keep Writing
proceduralgeneration: procedural generation
Bombing: Bombing
wanderlust: wanderlust
Cosmere: Cosmere
casualnintendo: casual nintendo
SUBREDDITNAME: SUBREDDITNAME
Anki: Anki
Aquascape: Aquascape
computertechs: computer techs
whoosh: whoosh
galaxys10: galaxy s10
vuejs: vuejs
Workspaces: Workspaces
hawks: hawks
StormiMaya: Stormi Maya
cursedcursedcomments: cursed cursed comments
sadboys: sad boys
LooneyTunesLogic: Looney Tunes Logic
cosmoandwanda: cosmo and wanda
supernovarevenge: supernova revenge
OffGridCabins: Off Grid Cabins
Flexicas: Flexicas
MyChemicalRomance: My Chemical Romance
AskFeminists: Ask Feminists
DiWHYNOT: DiY WHY NOT
sloths: sloths
Tubbo_: Tubbo_
AZURE: AZURE
DaisyKeech: Daisy Keech
TattooGirls: Tattoo Girls
theofficememes: the office memes
silenthill: silent hill
cottagecore: cottage core
ForgottenWeapons: Forgotten Weapons
kde: kde
chessbeginners: chess beginners
SplitDepthGIFS: Split Depth GIFS
Metroid: Metroid
ruby: ruby
transformers: transformers
WoT: WoT
nsfw_busted: nsfw busted
medical: medical
vegas: vegas
RotMG: RotMG
billiards: billiards
freelanceWriters: freelance Writers
HPHogwartsMystery: HPHogwarts Mystery
Charcuterie: Charcuterie
upvoteexeggutor: upvote exeggutor
selfharm: self harm
tails: tails
BATProject: BAT Project
bonnaroo: bonnaroo
CableManagement: Cable Management
dishonored: dishonored
Shrek: Shrek
Colts: Colts
Animedubs: Anime dubs
psychedelicrock: psychedelic rock
premiere: premiere
HouseplantsUK: Houseplants UK
gamingnews: gaming news
howardstern: howard stern
worstof: worst of
MacMiller: Mac Miller
CBDOilReviews: CBD Oil Reviews
SatisfIcing: Satisf Icing
GatekeepingYuri: Gatekeeping Yuri
shoegaze: shoegaze
OhItllBeFine: Oh It'll Be Fine
Pokemongiveaway: Pokemon giveaway
sailormoon: sailor moon
freshalbumart: fresh album art
UofT: U of T
videogames: video games
chomsky: chomsky
chanceme: chance me
electricdaisycarnival: electric daisy carnival
mattcolville: matt colville
podcasting: podcasting
SneakyBackgroundFeet: Sneaky Background Feet
uwaterloo: u Waterloo
cincinnati: cincinnati
DMDadJokes: DM Dad Jokes
FixedGearBicycle: Fixed Gear Bicycle
kickstarter: kickstarter
DokkanBattleCommunity: Dokkan Battle Community
bikesgonewild: bikes gone wild
giveaways: giveaways
FlutterDev: Flutter Dev
deadpool: deadpool
PCOS: PCOS
lostpause: lost pause
ModernWarzone: Modern Warzone
shouldercats: shoulder cats
GreenDawn: Green Dawn
homestuck: homestuck
PlasticSurgery: Plastic Surgery
FFXIVGlamours: FFXIV Glamours
katyperry: katy perry
chernobyl: chernobyl
euphoria: euphoria
Kenshi: Kenshi
attackeyes: attack eyes
LaptopDeals: Laptop Deals
ClimateActionPlan: Climate Action Plan
Soulnexus: Soulnexus
saplings: saplings
RedheadedGoddesses: Redheaded Goddesses
NoSleepOOC: No Sleep OOC
forsen: forsen
ENFP: ENFP
catsvstechnology: cats vs technology
NoahGetTheDeathStar: Noah Get The Death Star
OTBfreaks: OTB freaks
ShowerOrange: Shower Orange
RandomActsofCards: Random Acts of Cards
tasker: tasker
Wetshaving: Wet shaving
ASX_Bets: ASX Bets
Archero: Archero
LushCosmetics: Lush Cosmetics
mathematics: mathematics
transvoice: trans voice
Nikon: Nikon
boulder: boulder
indianapolis: indianapolis
genetics: genetics
insurgency: insurgency
mensfashion: mens fashion
conspiratard: conspiratard
iphonexwallpapers: iphone x wallpapers
astrologymemes: astrology memes
Mobpsycho100: Mob Psycho 100
ProtonMail: Proton Mail
AssassinsCreedOdyssey: Assassins Creed Odyssey
audible: audible
longboyes: long boys
AnimalCrossingNewLeaf: Animal Crossing New Leaf
ExNoContact: Ex No Contact
DetroitRedWings: Detroit Red Wings
baconit: baconit
CODMobile: COD Mobile
MonsterMusume: Monster Musume
Thatsactuallyverycool: That's actually very cool
GifSauces: Gif Sauces
vegangifrecipes: vegan gif recipes
PUBGXboxOne: PUBG Xbox One
KarmaRoulette: Karma Roulette
myfriendwantstoknow: my friend wants to know
FossilPorn: Fossil Porn
charcoal: charcoal
fitness30plus: fitness 30 plus
ps2: ps2
MinecraftBuddies: Minecraft Buddies
GothStyle: Goth Style
badlinguistics: bad linguistics
ShitPoliticsSays: Shit Politics Says
TryingForABaby: Trying For A Baby
Hawaii: Hawaii
stalker: stalker
OWConsole: OW Console
Divorce: Divorce
homeimprovementideas: home improvement ideas
F4M: F4M
DrawForMe: Draw For Me
Vent: Vent
short: short
Trading: Trading
BollyBlindsNGossip: Bolly Blinds N Gossip
chat: chat
KnightsOfPineapple: Knights Of Pineapple
Torontobluejays: Toronto blue jays
FindTheSniper: Find The Sniper
MindHunter: Mind Hunter
CineShots: Cine Shots
animalcrossingmeme: animal crossing meme
pcmods: pc mods
shitpostemblem: shitpost emblem
shubreddit: shubreddit
kpics: k pics
Netherlands: Netherlands
birdstakingthetrain: birds takin gthe train
DragaliaLost: Dragalia Lost
asiangirlsbeingcute: asian girls being cute
EmulationOnAndroid: Emulation On Android
vintageobscura: vintage obscura
ShitpostXIV: Shitpost XIV
evolution: evolution
adderall: adderall
penguins: penguins
rolex: rolex
starwarscollecting: star wars collecting
Kentucky: Kentucky
comicbookart: comic book art
ImaginaryColorscapes: Imaginary Colorscapes
weedbiz: weed biz
Roku: Roku
PERU: PERU
imsorryeveryone: im sorry everyone
MicrosoftFlightSim: Microsoft Flight Sim
blackhat: black hat
NormalDayInArabia: Normal Day In Arabia
okbuddybaka: ok buddy baka
Enneagram: Enneagram
BlueMidterm2018: Blue Midterm 2018
misanthropy: misanthropy
SweetHomeAlabama: Sweet Home Alabama
Garmin: Garmin
UnsolvedMurders: Unsolved Murders
stupidpol: stupid pol
PastAndPresentPics: Past And Present Pics
ImpracticalJokers: Impractical Jokers
CRedit: C Redit
GetMotivatedBuddies: Get Motivated Buddies
GunAccessoriesForSale: Gun Accessories For Sale
IndieFolk: Indie Folk
justlegbeardthings: just legbeard things
DogsMirin: Dogs Mirin
thefalconandthews: the falcon and the ws
StocksAndTrading: Stocks And Trading
oldbabies: old babies
ReefTank: Reef Tank
nonononoyesno: no no no yes no
espanol: espanol
CompetitiveForHonor: Competitive For Honor
CatsWhoSqueak: Cats Who Squeak
GRAMBADDIES: G R A M B A D D I E S
HouseOfCards: House Of Cards
weightwatchers: weight watchers
berkeley: berkeley
Ice_Poseidon: Ice_Poseidon
khiphop: kh i p hop
CowChop: Cow Chop
miraculousladybug: miraculous lady bug
notopbutok: no top but ok
vgb: vgb
Horses: Horses
Dell: Dell
23andme: 23 and me
controllablewebcams: controllable webcams
PoliceBrotality: Police Brotality
NoNewNormal: No New Normal
vscode: vs code
Slovakia: Slovakia
bodymods: body mods
IKEA: IKEA
MakeupLounge: Makeup Lounge
TrailGuides: Trail Guides
SpoiledDragRace: Spoiled Drag Race
IdleHeroes: Idle Heroes
legaladvicecanada: legal advice canada
YuB: Yu B
Cleveland: Cleveland
mkbhd: mkbhd
SuperModelIndia: Super Model India
FinalFantasyVII: Final Fantasy VII
phish: phish
selfpublish: self publish
diyelectronics: diy electronics
unexpectedMontyPython: unexpected Monty Python
CandidFashionPolice: Candid Fashion Police
Lightroom: Lightroom
doge: doge
Psychiatry: Psychiatry
guitars: guitars
illnessfakers: illness fakers
phonewallpapers: phone wallpapers
YUROP: YUROP
FridayNightFunkin: Friday Night Funkin
creepygaming: creepy gaming
depression_help: depression help
FridgeDetective: Fridge Detective
religion: religion
bon_appetit: bon appetit
Metallica: Metallica
AndroidWear: Android Wear
camphalfblood: camp half blood
mapporncirclejerk: map porn circle jerk
PKA: P K A
Office365: Office 365
Slipknot: Slipknot
beautytalkph: beauty talk ph
entwives: ent wives
FromPuppyToDog: From Puppy To Dog
Entomology: Entomology
AskBaking: Ask Baking
SelfDrivingCars: Self Driving Cars
enlightenedbirdmen: enlightened bird men
javahelp: java help
thereifixedit: there i fixed it
musicals: musicals
retiredgif: retired gif
silhouWHAT: silhou what
G59: G 59
Animals: Animals
psych: psych
Madisonbeer: Madison Beer
iOSsetups: iOS setups
osx: os x
Biochemistry: Biochemistry
Twitter: Twitter
PrincessesOfPower: Princesses Of Power
fuckwasps: fuck wasps
Astroneer: Astroneer
askTO: ask TO
MikomiHokina: Mikomi Hokina
disneyparks: disney parks
solar: solar
hoggit: hog git
Sierra_Skye: Sierra Skye
oldschoolcreepy: old school creepy
aesthetic: aesthetic
Brochet: Brochet
Whatthefuckgetitoffme: What the fuck get it off me
webhosting: web hosting
C_S_T: C S T
SCPDeclassified: SCP Declassified
iPadPro: iPad Pro
DIY_eJuice: DIY e Juice
Impeach_Trump: Impeach Trump
bikepacking: bike packing
NaughtyThrowawayF: Naughty Throwaway F
LoLeventVoDs: LoL event VODs
inspirobot: inspirobot
Jeopardy: Jeopardy
oddlyweird: oddly weird
granturismo: gran turismo
sleep: sleep
knifemaking: knife making
TravelHacks: Travel Hacks
HPfanfiction: HP fan fiction
delhi: delhi
AskProgramming: Ask Programming
WRX: W R X
conspiracy_commons: conspiracy commons
okaybuddyretard: okay buddy retard
redstone: red stone
CulinaryPlating: Culinary Plating
WidescreenWallpaper: Widescreen Wallpaper
VaporwaveArt: Vaporwave Art
EnoughMuskSpam: Enough Musk Spam
WearOS: Wear OS
rosin: rosin
hockeyplayers: hockey players
EmmaKotos: Emma Kotos
ValveIndex: Valve Index
CodeGeass: Code Geass
Tennesseetitans: Tennessee titans
gis: gis
ConsumeProduct: Consume Product
MarchAgainstNazis: March Against Nazis
fut: fut
commandline: command line
nathanwpyle: nathan wpyle
Trophies: Trophies
serialpodcast: serial podcast
fixingmovies: fixing movies
vanderpumprules: vanderpump rules
Rihanna: Rihanna
OnionLovers: Onion Lovers
BattlePaintings: Battle Paintings
GenderCritical: Gender Critical
typescript: typescript
Hedgehog: Hedgehog
TheEricAndreShow: The Eric Andre Show
deeplearning: deep learning
arabs: arabs
whole30: whole 30
MemriTVmemes: Memri TV memes
IsolatedVocals: Isolated Vocals
coronanetherlands: corona netherlands
exercisepostures: exercise postures
meat: meat
MichaelReeves: Michael Reeves
geometrydash: geometry dash
ChargeYourPhone: Charge Your Phone
DrugStashes: Drug Stashes
CivVI: Civ VI
Intelligence: Intelligence
IDAP: I D A P
CelebBattles: Celeb Battles
PinkOmega: Pink Omega
reclaimedbynature: reclaimed by nature
BadArt: Bad Art
ufo: ufo
LGBTnews: LGBT news
godot: godot
geologyporn: geology porn
Sino: Sino
AubreyPlaza: Aubrey Plaza
ukulele: ukulele
shittyaquariums: shitty aquariums
GymMotivation: Gym Motivation
fuxtaposition: fuxtaposition
eupersonalfinance: eu personal finance
RepublicaArgentina: Republica Argentina
microbiology: microbiology
VeryExpensive: Very Expensive
trains: trains
readwithme: read with me
nagatoro: nagatoro
turning: turning
Drizzy: Drizzy
shittyaskreddit: shitty ask reddit
AryaWinsTheThrone: Arya Wins The Throne
NevilleGoddard: Neville Goddard
GilmoreGirls: Gilmore Girls
ATAAE: A T A A E
Hydroponics: Hydroponics
abv: a b v
FireEmblemThreeHouses: Fire Emblem Three Houses
SexyYouTubers: Sexy YouTubers
theoffice: the office
aquaponics: aquaponics
glutenfree: gluten free
Gamecube: Gamecube
makeuporganization: makeup organization
USPS: USPS
lanadelrey: Lana Del Rey
bioinformatics: bioinformatics
CoronavirusDownunder: Coronavirus Downunder
Bogleheads: Bogleheads
knolling: knolling
FixMyPrint: Fix My Print
NobodyWinsTheThrone: Nobody Wins The Throne
AlternateHistory: Alternate History
Moustache: Moustache
magicthecirclejerking: magic the circle jerking
healthcare: health care
aldi: aldi
juxtaposition: juxtaposition
ukraina: ukraina
PhilosophyMemes: Philosophy Memes
PORTUGALCARALHO: PORTUGAL CARALHO
truetf2: true tf2
CaesarsWorld: Caesars World
haskell: haskell
suddenlybi: suddenly bi
rollercoasters: roller coasters
herpetology: herpetology
crappycontouring: crappy contouring
adhdwomen: adhd women
PampamilyangPaoLUL: Pampamilyang Pao LUL
TeslaModel3: Tesla Model 3
AMDHelp: AMD Help
aerospace: aerospace
tokkiefeesboek: tokkie fees boek
VoteBlue: Vote Blue
justa: just a
Chargers: Chargers
ForShub: For Shub
flask: flask
GlobalTalk: Global Talk
badtaxidermy: bad taxidermy
YouTube_startups: YouTube startups
PointlessStories: Pointless Stories
NolanBatmanMemes: Nolan Batman Memes
Braves: Braves
cosmickitten: cosmic kitten
conlangs: conlangs
homeschool: home school
talentShow: talent Show
nrl: nrl
Ozark: Ozark
MobKitchen: Mob Kitchen
bustyisraeligirls: busty israeli girls
transadorable: trans adorable
DarkFuturology: Dark Futurology
cheatatmathhomework: cheat at math homework
artcommissions: art commissions
Pottery: Pottery
northernlion: northern lion
csgomarketforum: cs go market forum
Serendipity: Serendipity
Shamanism: Shamanism
WarhammerCompetitive: Warhammer Competitive
badroommates: badroommates
RationalPsychonaut: Rational Psychonaut
Dabs: Dabs
nudism: nudism
PlanetZoo: Planet Zoo
Roast_Me: Roast Me
shittyprogramming: shitty programming
FortWorth: Fort Worth
disenchantment: disenchantment
juul: juul
retrobattlestations: retro battle stations
ImaginaryJedi: Imaginary Jedi
forhonorknights: for honor knights
PaymoneyWubby: Paymoney Wubby
truezelda: true zelda
exjw: exjw
southcarolina: south carolina
pottedcats: potted cats
AmITheAngel: Am I The Angel
TBJZL: TBJZL
crashbandicoot: crash bandicoot
streetmoe: street moe
NatalieRoush: Natalie Roush
PSO2: PSO2
illinois: illinois
mazda: mazda
punchablefaces: punchable faces
DaveRamsey: Dave Ramsey
kubernetes: kubernetes
PlanetDolan: Planet Dolan
clevelandcavs: cleveland cavs
Jewdank: Jewdank
holofractal: holo fractal
HaloStory: Halo Story
roguelikes: rogue likes
forbiddenboops: forbidden boops
House: House
Nerf: Nerf
SkyrimPorn: Skyrim Porn
SFWPornGifs: SFW Porn Gifs
dehydrating: dehydrating
RogueCompany: Rogue Company
bestofworldstar: best of world star
Hardcore: Hardcore
Nurse: Nurse
KoreanFood: Korean Food
Brooklyn: Brooklyn
fullmoviesongoogle: full movies on google
AdultsAreFuckinStupid: Adults Are Fuckin Stupid
DynastyFF: Dynasty FF
cricut: cricut
SwitchPirates: Switch Pirates
Monstercat: Monstercat
Granblue_en: Granblue en
ChemicalEngineering: Chemical Engineering
iPhoneography: iPhoneography
Jaguars: Jaguars
NegativeWithGold: Negative With Gold
Magicdeckbuilding: Magic deck building
livesound: live sound
Mujico: Mujico
RebornDollCringe: Reborn Doll Cringe
Boardgamedeals: Boardgame deals
Cinderblock: Cinderblock
upcycling: upcycling
TrueChristian: True Christian
ShieldAndroidTV: Shield Android TV
Spellbreak: Spellbreak
BestOfOutrageCulture: Best Of Outrage Culture
SkyrimTogether: Skyrim Together
BernieSanders: Bernie Sanders
startup: startup
PiratePets: Pirate Pets
gisellelynette: Giselle Lynette
acting: acting
quarantineactivities: quarantine activities
pens: pens
DHgate: DHgate
Winnipeg: Winnipeg
labrador: labrador
Liftingmusic: Lifting music
ontheledgeandshit: on the ledge and shit
DigitalMarketing: Digital Marketing
PurpleCoco: Purple Coco
astrologyreadings: astrology readings
Wales: Wales
DragonMaid: Dragon Maid
XFiles: X Files
Bento: Bento
ArtisanGifts: Artisan Gifts
japancirclejerk: japan circle jerk
Noearthsociety: No Earth Society
CoutureReps: Couture Reps
gamemaker: game maker
iran: iran
stimuluscheck: stimulus check
freestickers: free stickers
mmamemes: mma memes
Firefighting: Firefighting
SarahRoseMcDaniel: Sarah Rose McDaniel
MegalithPorn: Megalith Porn
postrock: post rock
Judaism: Judaism
UpvotedBecauseGirl: Upvoted Because Girl
InvestmentClub: Investment Club
kik: kik
codes: codes
FirstTimeHomeBuyer: First Time Home Buyer
c137: c137
homedefense: home defense
motorcycle: motorcycle
canon: canon
LivestreamFails: Livestream Fails
KindVoice: Kind Voice
Perlalov: Perlalov
sixwordstories: six word stories
bizarrelife: bizarre life
ArchitecturalRevival: Architectural Revival
civilengineering: civil engineering
PoliticalCompass: Political Compass
Vocaloid: Vocaloid
RetroArch: Retro Arch
ProgrammingLanguages: Programming Languages
GolfGTI: Golf GTI
Shroud: Shroud
transgendercirclejerk: transgender circle jerk
caloriecount: calorie count
BethLily: Beth Lily
wildlypenis: wildly penis
druggardening: drug gardening
thinspo: thinspo
hamsters: hamsters
SpecialSnowflake: Special Snowflake
NewVegasMemes: New Vegas Memes
Sims3: Sims 3
Supreme: Supreme
GamersBeingBros: Gamers Being Bros
theXeffect: the X effect
LuxuryLifeHabits: Luxury Life Habits
darkmeme: dark meme
mobilephotography: mobile photography
Stronglifts5x5: Stronglifts 5x5
ClothedNaked: Clothed Naked
SoccerBetting: Soccer Betting
Dank: Dank
HeavyFuckingWind: Heavy Fucking Wind
kaleycuoco: Kaley Cuoco
PokemonMasters: Pokemon Masters
TownofSalemgame: Town of Salem game
memeframe: meme frame
dbfz: dbfz
Songwriting: Songwriting
LouderWithCrowder: Louder With Crowder
fashionsouls: fashion souls
rpcs3: rpcs3