Science: r/science, r/askscience, r/explainlikeimfive, r/space, r/physics, r/chemistry, r/biology, r/earthporn...

Humor: r/funny, r/Jokes, r/memes, r/dankmemes, r/facepalm, r/cringepics, r/woooosh, r/tumblr, r/iamverysmart...

Technology: r/gadgets, r/techsupport, r/programming, r/Android, r/iPhone, r/compsci, r/linux, r/hacking, r/gaming...

News: r/worldnews, r/news, r/nottheonion, r/politics, r/UpliftingNews, r/CryptoCurrency, r/economics, r/business...

Personal finance: r/personalfinance, r/investing, r/financialindependence, r/StockMarket, r/CryptoMarkets, r/financialindependence, r/RealEstateInvesting...

Relationships: r/relationship_advice, r/dating_advice, r/sex, r/relationshipadvice, r/dating, r/AskMen, r/AskWomen, r/LGBT, r/Marriage...

Gaming: r/gaming, r/pcgaming, r/PS4, r/nintendo, r/XboxOne, r/gamingcirclejerk, r/Steam, r/AnimalCrossing, r/FortniteBR...

Movies & TV shows: r/movies, r/television, r/NetflixBestOf, r/movie_details, r/GameOfThrones, r/MarvelStudios, r/TheWalkingDead, r/horror...

Music: r/Music, r/listentothis, r/hiphopheads, r/EDM, r/classicalmusic, r/WeAreTheMusicMakers, r/indieheads, r/Kanye, r/GlobalOffensive...

Art & Design: r/Art, r/Design, r/ArtPorn, r/photography, r/Streetwear, r/typography, r/graffiti, r/AmateurRoomPorn, r/Architecture...

Food: r/food, r/foodporn, r/Cooking, r/recipes, r/foodhacks, r/EatCheapAndHealthy, r/baking, r/slowcooking, r/MealPrepSunday...

Fitness & Health: r/Fitness, r/loseit, r/xxfitness, r/running, r/bodyweightfitness, r/yoga, r/weightlifting, r/intermittentfasting, r/keto...

Travel: r/travel, r/solotravel, r/backpacking, r/JapanTravel, r/roadtrip, r/CampingandHiking, r/travelhacking, r/Thailand, r/Europe...

Books: r/books, r/bookclub, r/literature, r/suggestmeabook, r/audiobooks, r/Fantasy, r/HarryPotter, r/StephenKing, r/BookRecommendations...

Sports: r/sports, r/nfl, r/nba, r/baseball, r/soccer, r/hockey, r/MMA, r/tennis, r/formula1...

History: r/history, r/AskHistorians, r/historymemes, r/historyporn, r/HistoryMemes, r/ancientgreece, r/AmericanHistory, r/badhistory...

Philosophy: r/philosophy, r/Stoicism, r/badphilosophy, r/Existentialism, r/AcademicPhilosophy, r/philosophyofscience, r/askphilosophy, r/epistemology...

Coding & Programming: r/programming, r/learnprogramming, r/coding, r/webdev, r/javascript, r/python, r/java, r/cscareerquestions...

DIY & Crafts: r/DIY, r/woodworking, r/crafts, r/sewing, r/embroidery, r/knitting, r/crochet, r/Pottery, r/leathercraft...

Fashion: r/malefashionadvice, r/femalefashionadvice, r/streetwear, r/sneakers, r/malelivingspace, r/fashionreps, r/frugalmalefashion, r/wardrobepurge...

Nature & Wildlife: r/aww, r/EarthPorn, r/AnimalKingdom, r/NatureisFuckingLit, r/whatisthisplant, r/botany, r/Ornithology, r/herpetology...

Parenting: r/Parenting, r/Mommit, r/daddit, r/pregnant, r/AttachmentParenting, r/breastfeeding, r/toddlers, r/SingleParents, r/Fosterparents...

Photography: r/photography, r/itookapicture, r/photoclass2021, r/postprocessing, r/photographytips, r/astrophotography, r/streetphotography, r/landscapephotography...

Animals: r/aww, r/AnimalsBeingBros, r/AnimalsBeingJerks, r/Cats, r/Dogs, r/birds, r/reptiles, r/marinebiology, r/Entomology...

Mental health: r/mentalhealth, r/depression, r/anxiety, r/ADHD, r/therapy, r/selfcare, r/psychology, r/SuicideWatch, r/Addiction...

Politics & Current Events: r/politics, r/worldnews, r/news, r/politicalhumor, r/politicaldiscussion, r/geopolitics, r/Conservative, r/LateStageCapitalism...

Education & Learning: r/educationalgifs, r/college, r/learnmath, r/askscience, r/AskHistorians, r/LearnUselessTalents, r/LearnJapanese, r/languagelearning...

Motivation & Inspirational: r/GetMotivated, r/Motivation, r/inspiration, r/Entrepreneur, r/selfimprovement, r/productivity, r/Mindfulness, r/DecidingToBeBetter...

Cooking & Recipes: r/recipes, r/Cooking, r/MealPrepSunday, r/AskCulinary, r/slowcooking, r/budgetfood, r/veganrecipes, r/grilledcheese, r/instantpotrecipes...

Internet & Technology trends: r/InternetIsBeautiful, r/dataisbeautiful, r/technews, r/OutOfTheLoop, r/TechSupportGore, r/thingscutinhalfporn, r/softwaregore, r/techsupport, r/netsec...